//MAP CONVERTED BY dmm2tgm.py THIS HEADER COMMENT PREVENTS RECONVERSION, DO NOT REMOVE
"aj" = (
/turf/closed/mineral/bedrock,
/area/rogue/under/tomb)
"ar" = (
/turf/closed/wall/mineral/stone,
/area/rogue/under/tomb)
"av" = (
/turf/open/floor/cobble,
/area/rogue/under/tomb)
"aV" = (
/turf/closed/wall/mineral/stone/moss,
/area/rogue/under/tomb)
"aY" = (
/obj/effect/dungeon_directional_helper/south,
/turf/open/floor/cobble,
/area/rogue/under/tomb)
"bb" = (
/obj/structure/roguetent,
/turf/open/floor/cobble,
/area/rogue/under/tomb)
"bO" = (
/obj/structure/fluff/walldeco/skullspike,
/turf/open/floor/cobble,
/area/rogue/under/tomb)
"dP" = (
/obj/effect/decal/remains/human,
/obj/effect/decal/cleanable/blood/old,
/turf/open/floor/metal,
/area/rogue/under/tomb)
"gB" = (
/obj/structure/bars,
/turf/open/floor/metal,
/area/rogue/under/tomb)
"gL" = (
/obj/machinery/light/fueled/torchholder/r,
/turf/open/floor/cobble,
/area/rogue/under/tomb)
"hl" = (
/obj/effect/decal/cleanable/dirt,
/turf/open/floor/ruinedwood/darker,
/area/rogue/under/tomb)
"jP" = (
/obj/effect/decal/cleanable/blood/old,
/turf/open/floor/metal,
/area/rogue/under/tomb)
"pq" = (
/obj/effect/dungeon_directional_helper/west,
/turf/open/floor/cobble,
/area/rogue/under/tomb)
"pG" = (
/obj/structure/closet/crate/chest/old_crate,
/obj/item/reagent_containers/glass/bottle/healthpot,
/obj/item/reagent_containers/food/snacks/meat/sausage,
/obj/item/reagent_containers/food/snacks/meat/sausage,
/obj/item/reagent_containers/food/snacks/meat/sausage,
/obj/effect/decal/cleanable/dirt/cobweb/cobweb2,
/turf/open/floor/cobble,
/area/rogue/under/tomb)
"tP" = (
/mob/living/simple_animal/hostile/retaliate/troll/axe,
/obj/effect/decal/cleanable/blood,
/turf/open/floor/metal,
/area/rogue/under/tomb)
"ub" = (
/turf/open/floor/ruinedwood/darker,
/area/rogue/under/tomb)
"vk" = (
/obj/machinery/light/fueled/torchholder/c,
/turf/open/floor/ruinedwood/darker,
/area/rogue/under/tomb)
"vz" = (
/obj/effect/decal/cleanable/blood/old,
/obj/effect/decal/remains/bigrat,
/turf/open/floor/metal,
/area/rogue/under/tomb)
"yi" = (
/obj/effect/decal/cleanable/dirt,
/turf/open/floor/cobble,
/area/rogue/under/tomb)
"zg" = (
/obj/effect/decal/remains/bigrat,
/turf/open/floor/cobble,
/area/rogue/under/tomb)
"zv" = (
/obj/effect/decal/cleanable/blood/tracks{
	dir = 6
	},
/turf/open/floor/cobble,
/area/rogue/under/tomb)
"Ah" = (
/obj/machinery/light/fueled/torchholder/c,
/obj/effect/decal/cleanable/generic,
/turf/open/floor/ruinedwood/darker,
/area/rogue/under/tomb)
"Bi" = (
/obj/effect/decal/cleanable/blood,
/turf/open/floor/metal,
/area/rogue/under/tomb)
"Cv" = (
/obj/structure/door,
/turf/open/floor/ruinedwood/darker,
/area/rogue/under/tomb)
"DH" = (
/obj/machinery/light/fueled/torchholder/l,
/turf/open/floor/ruinedwood/darker,
/area/rogue/under/tomb)
"DT" = (
/obj/effect/decal/remains/human,
/turf/open/floor/cobble,
/area/rogue/under/tomb)
"EY" = (
/obj/effect/decal/cleanable/blood/old,
/obj/machinery/light/fueled/torchholder/l,
/turf/open/floor/cobble,
/area/rogue/under/tomb)
"Ft" = (
/mob/living/carbon/human/species/goblin/npc/cave,
/obj/effect/decal/cleanable/dirt,
/turf/open/floor/cobble,
/area/rogue/under/tomb)
"GJ" = (
/obj/effect/decal/cleanable/dirt,
/obj/effect/decal/remains/bigrat,
/turf/open/floor/cobble,
/area/rogue/under/tomb)
"Hs" = (
/obj/structure/door/iron/bars,
/turf/open/floor/metal,
/area/rogue/under/tomb)
"HD" = (
/obj/effect/dungeon_directional_helper/north,
/turf/open/floor/cobble,
/area/rogue/under/tomb)
"HT" = (
/obj/effect/decal/cleanable/blood,
/turf/open/floor/cobble,
/area/rogue/under/tomb)
"Ki" = (
/obj/effect/decal/remains/human,
/turf/open/floor/metal,
/area/rogue/under/tomb)
"Kp" = (
/obj/effect/decal/cleanable/generic,
/turf/open/floor/ruinedwood/darker,
/area/rogue/under/tomb)
"Ks" = (
/obj/machinery/light/fueled/campfire/densefire,
/turf/open/floor/cobble,
/area/rogue/under/tomb)
"Kv" = (
/mob/living/carbon/human/species/goblin/npc/cave,
/turf/open/floor/cobble,
/area/rogue/under/tomb)
"Lm" = (
/obj/structure/roguetent,
/obj/effect/decal/cleanable/dirt/cobweb,
/turf/open/floor/cobble,
/area/rogue/under/tomb)
"Mp" = (
/obj/item/skull,
/obj/item/skull,
/obj/item/skull{
	pixel_y = 2;
	pixel_x = 8
	},
/obj/item/skull{
	pixel_x = 4;
	pixel_y = -3
	},
/obj/item/skull{
	pixel_x = 5;
	pixel_y = 5
	},
/obj/item/skull{
	pixel_y = 10
	},
/turf/open/floor/cobble,
/area/rogue/under/tomb)
"MA" = (
/obj/machinery/light/fueled/torchholder/r,
/turf/open/floor/ruinedwood/darker,
/area/rogue/under/tomb)
"Oa" = (
/obj/machinery/light/fueled/torchholder{
	pixel_y = -32
	},
/turf/open/floor/ruinedwood/darker,
/area/rogue/under/tomb)
"Pi" = (
/turf/open/floor/metal,
/area/rogue/under/tomb)
"Pj" = (
/obj/machinery/light/fueled/torchholder/l,
/obj/effect/decal/cleanable/generic,
/turf/open/floor/ruinedwood/darker,
/area/rogue/under/tomb)
"RG" = (
/obj/effect/decal/cleanable/blood/tracks{
	dir = 4
	},
/turf/open/floor/cobble,
/area/rogue/under/tomb)
"TW" = (
/obj/effect/dungeon_directional_helper/east,
/turf/open/floor/cobble,
/area/rogue/under/tomb)
"VH" = (
/obj/machinery/light/fueled/torchholder/l,
/turf/open/floor/cobble,
/area/rogue/under/tomb)
"WX" = (
/obj/effect/decal/cleanable/blood/old,
/turf/open/floor/cobble,
/area/rogue/under/tomb)
"Yb" = (
/obj/effect/decal/cleanable/blood/splatter,
/turf/open/floor/cobble,
/area/rogue/under/tomb)

(1,1,1) = {"
aj
aj
aj
aj
aj
pq
av
aj
aj
aj
aj
aj
"}
(2,1,1) = {"
aj
aV
aV
ar
ar
av
av
ar
aV
ar
aV
aj
"}
(3,1,1) = {"
aj
aV
Lm
VH
bb
WX
av
bO
EY
zg
ar
aj
"}
(4,1,1) = {"
aj
ar
DT
WX
av
av
av
av
VH
yi
ar
aj
"}
(5,1,1) = {"
aj
ar
bb
av
bb
av
av
av
av
GJ
aV
aj
"}
(6,1,1) = {"
HD
av
yi
av
av
av
HT
HT
WX
av
av
aY
"}
(7,1,1) = {"
av
av
yi
av
av
WX
Yb
Yb
av
av
av
av
"}
(8,1,1) = {"
aj
aV
Kv
av
Kv
yi
RG
WX
DT
av
ar
aj
"}
(9,1,1) = {"
aj
aV
av
Ks
Kv
av
RG
bO
Mp
av
aV
aj
"}
(10,1,1) = {"
aj
aV
pG
yi
Ft
av
zv
av
gL
yi
aV
aj
"}
(11,1,1) = {"
aj
ar
ar
ar
ar
av
av
aV
aV
aV
ar
aj
"}
(12,1,1) = {"
aj
aj
aj
aj
aj
TW
av
aj
aj
aj
aj
aj
"}

(1,1,2) = {"
aj
aj
aj
aj
aj
Cv
Cv
aj
aj
aj
aj
aj
"}
(2,1,2) = {"
aj
ub
ub
ub
DH
ub
ub
Pj
ub
hl
hl
aj
"}
(3,1,2) = {"
aj
hl
hl
ub
ub
ub
ub
Kp
ub
ub
ub
aj
"}
(4,1,2) = {"
aj
ub
hl
gB
gB
gB
gB
gB
gB
ub
ub
aj
"}
(5,1,2) = {"
aj
vk
ub
gB
Pi
tP
Pi
Pi
gB
ub
Oa
aj
"}
(6,1,2) = {"
Cv
ub
ub
Hs
Pi
dP
Pi
jP
Hs
ub
ub
Cv
"}
(7,1,2) = {"
Cv
ub
ub
Hs
Pi
Pi
Bi
Ki
Hs
ub
ub
Cv
"}
(8,1,2) = {"
aj
Ah
ub
gB
jP
vz
jP
Pi
gB
Kp
Oa
aj
"}
(9,1,2) = {"
aj
ub
ub
gB
gB
gB
gB
gB
gB
hl
ub
aj
"}
(10,1,2) = {"
aj
ub
ub
Kp
ub
ub
ub
ub
hl
hl
ub
aj
"}
(11,1,2) = {"
aj
ub
Kp
Kp
MA
ub
ub
MA
ub
hl
ub
aj
"}
(12,1,2) = {"
aj
aj
aj
aj
aj
Cv
Cv
aj
aj
aj
aj
aj
"}
