//MAP CONVERTED BY dmm2tgm.py THIS HEADER COMMENT PREVENTS RECONVERSION, DO NOT REMOVE
"br" = (
/turf/open/floor/ruinedwood/spiral,
/area/rogue/under/tomb/indoors)
"bx" = (
/turf/open/water/swamp/deep,
/area/rogue/under/tomb/cave)
"db" = (
/obj/effect/decal/cleanable/sigil,
/obj/item/reagent_containers/powder/ozium{
	pixel_y = 2
	},
/obj/item/reagent_containers/powder/ozium{
	pixel_y = 15;
	pixel_x = -19
	},
/obj/item/reagent_containers/powder/ozium{
	pixel_y = 23
	},
/obj/item/reagent_containers/powder/ozium{
	pixel_y = 14;
	pixel_x = 21
	},
/obj/item/reagent_containers/powder/ozium{
	pixel_y = -12;
	pixel_x = -13
	},
/obj/item/reagent_containers/powder/ozium{
	pixel_y = -13;
	pixel_x = 14
	},
/turf/open/floor/ruinedwood/spiral,
/area/rogue/under/tomb/indoors)
"dL" = (
/obj/structure/bed/inn/double,
/obj/item/bedsheet/fabric_double,
/turf/open/floor/ruinedwood/spiral,
/area/rogue/under/tomb/indoors)
"fs" = (
/obj/machinery/light/fueled/wallfire/candle/blue/r,
/turf/open/floor/ruinedwood/spiral,
/area/rogue/under/tomb/indoors)
"fv" = (
/obj/machinery/light/fueled/wallfire/candle/blue,
/obj/structure/closet/crate/drawer/inn,
/turf/open/floor/ruinedwood/spiral,
/area/rogue/under/tomb/indoors)
"gO" = (
/obj/structure/door/fancy,
/obj/effect/mapping_helpers/door/locker,
/turf/open/floor/ruinedwood/spiral,
/area/rogue/under/tomb/indoors)
"gX" = (
/mob/living/carbon/human/species/skeleton/npc/ambush,
/turf/open/water/swamp/deep,
/area/rogue/under/tomb/cave/wet)
"gZ" = (
/obj/machinery/light/fueled/wallfire/candle/blue/l,
/turf/open/floor/ruinedwood/spiral,
/area/rogue/under/tomb/indoors)
"hm" = (
/obj/structure/bed/shit,
/obj/item/statue/iron,
/turf/open/floor/ruinedwood/spiral,
/area/rogue/under/tomb/indoors)
"hp" = (
/obj/structure/door/swing,
/obj/item/soap/bath{
	pixel_y = -5
	},
/turf/open/floor/tile,
/area/rogue/under/tomb/indoors)
"io" = (
/obj/effect/decal/cleanable/sigil/NW,
/turf/open/floor/ruinedwood/spiral,
/area/rogue/under/tomb/indoors)
"jl" = (
/turf/open/transparent/openspace,
/area/rogue/under/tomb/cave/wet)
"jr" = (
/obj/item/statue/steel,
/turf/open/floor/tile,
/area/rogue/under/tomb/indoors)
"ke" = (
/turf/closed/indestructible/roguewindow,
/area/rogue/under/tomb/indoors)
"kT" = (
/mob/living/carbon/human/species/skeleton/npc/ambush,
/turf/open/water/swamp/deep,
/area/rogue/under/tomb/cave)
"la" = (
/turf/closed/wall/mineral/decowood/vert,
/area/rogue/under/tomb/indoors)
"lc" = (
/mob/living/carbon/human/species/skeleton/npc/ambush,
/turf/open/water/bath,
/area/rogue/under/tomb/indoors)
"lp" = (
/obj/effect/decal/cleanable/sigil/S,
/turf/open/floor/ruinedwood/spiral,
/area/rogue/under/tomb/indoors)
"nN" = (
/turf/open/water/bath,
/area/rogue/under/tomb/indoors)
"oM" = (
/mob/living/carbon/human/species/zizombie/npc/militiamen,
/obj/item/clothing/ring/gold/gemerald,
/obj/effect/mapping_helpers/floor_clothing_equipper,
/turf/open/floor/ruinedwood/spiral,
/area/rogue/under/tomb/indoors)
"pe" = (
/obj/structure/rack/shelf/big,
/obj/item/perfume/random{
	pixel_y = 25
	},
/obj/item/perfume/random{
	pixel_y = 27;
	pixel_x = 13
	},
/turf/open/floor/ruinedwood/spiral,
/area/rogue/under/tomb/indoors)
"pC" = (
/obj/machinery/light/fueled/wallfire/candle/blue,
/turf/open/floor/tile,
/area/rogue/under/tomb/indoors)
"pT" = (
/obj/structure/bed/shit,
/mob/living/carbon/human/species/skeleton/npc/peasant,
/turf/open/floor/ruinedwood/spiral,
/area/rogue/under/tomb/indoors)
"qr" = (
/obj/item/storage/belt/pouch,
/obj/structure/table/vtable/v2,
/turf/open/floor/ruinedwood/spiral,
/area/rogue/under/tomb/indoors)
"qz" = (
/obj/effect/decal/cleanable/sigil/SW,
/turf/open/floor/ruinedwood/spiral,
/area/rogue/under/tomb/indoors)
"rx" = (
/obj/structure/rack/shelf/big,
/obj/item/perfume/random{
	pixel_y = 24
	},
/obj/item/perfume/random{
	pixel_y = 24;
	pixel_x = 12
	},
/turf/open/floor/ruinedwood/spiral,
/area/rogue/under/tomb/indoors)
"rF" = (
/obj/machinery/light/fueled/wallfire/candle/blue,
/obj/structure/table/vtable,
/obj/item/storage/belt/pouch,
/turf/open/floor/ruinedwood/spiral,
/area/rogue/under/tomb/indoors)
"sj" = (
/obj/item/soap{
	pixel_x = -3;
	pixel_y = -5
	},
/obj/structure/door/swing,
/turf/open/floor/ruinedwood/spiral,
/area/rogue/under/tomb/indoors)
"sz" = (
/obj/machinery/light/fueled/wallfire/candle/blue,
/obj/structure/closet/crate/drawer/inn,
/obj/item/gem/blue,
/turf/open/floor/ruinedwood/spiral,
/area/rogue/under/tomb/indoors)
"sV" = (
/turf/open/transparent/openspace,
/area/rogue/under/tomb/indoors)
"uG" = (
/mob/living/carbon/human/species/skeleton/npc/warrior,
/turf/open/floor/ruinedwood/spiral,
/area/rogue/under/tomb/indoors)
"wp" = (
/obj/structure/stairs,
/turf/open/floor/tile,
/area/rogue/under/tomb/indoors)
"xf" = (
/turf/open/water/swamp/deep,
/area/rogue/under/tomb/cave/wet)
"xg" = (
/obj/effect/decal/cleanable/sigil/W,
/mob/living/carbon/human/species/skeleton/npc/warrior,
/turf/open/floor/ruinedwood/spiral,
/area/rogue/under/tomb/indoors)
"yA" = (
/obj/item/soap/bath{
	pixel_y = -5
	},
/turf/open/water/bath,
/area/rogue/under/tomb/indoors)
"zF" = (
/mob/living/carbon/human/species/skeleton/npc/peasant,
/turf/open/floor/ruinedwood/spiral,
/area/rogue/under/tomb/indoors)
"Ae" = (
/obj/machinery/light/fueled/wallfire/candle/blue,
/turf/open/water/bath,
/area/rogue/under/tomb/indoors)
"Aj" = (
/obj/machinery/light/fueled/wallfire/candle/blue,
/obj/structure/rack/shelf/big,
/obj/item/perfume/random{
	pixel_y = 25
	},
/obj/item/perfume/random{
	pixel_y = 23;
	pixel_x = 14
	},
/turf/open/floor/ruinedwood/spiral,
/area/rogue/under/tomb/indoors)
"At" = (
/obj/machinery/light/fueled/wallfire/candle/blue,
/obj/structure/bed/shit,
/turf/open/floor/ruinedwood/spiral,
/area/rogue/under/tomb/indoors)
"Av" = (
/mob/living/carbon/human/species/skeleton/npc/ambush,
/turf/open/floor/ruinedwood/spiral,
/area/rogue/under/tomb/indoors)
"AV" = (
/turf/open/floor/rooftop,
/area/rogue/under/tomb/cave/wet)
"BP" = (
/obj/structure/rack/shelf/big,
/obj/item/perfume/random{
	pixel_y = 24
	},
/obj/item/perfume/random{
	pixel_x = 12;
	pixel_y = 27
	},
/turf/open/floor/ruinedwood/spiral,
/area/rogue/under/tomb/indoors)
"BV" = (
/turf/open/floor/rooftop{
	dir = 1
	},
/area/rogue/under/tomb/cave/wet)
"Cj" = (
/turf/open/floor/naturalstone,
/area/rogue/under/tomb/cave/wet)
"Ft" = (
/obj/effect/dungeon_directional_helper/north,
/turf/open/floor/dirt,
/area/rogue/under/tomb/cave/wet)
"Fz" = (
/mob/living/carbon/human/species/skeleton/npc/warrior/skilled,
/turf/open/floor/ruinedwood/spiral,
/area/rogue/under/tomb/indoors)
"FD" = (
/obj/effect/decal/cleanable/sigil/NE,
/turf/open/floor/ruinedwood/spiral,
/area/rogue/under/tomb/indoors)
"Gx" = (
/turf/open/floor/tile,
/area/rogue/under/tomb/indoors)
"GE" = (
/obj/structure/door/swing,
/turf/open/floor/tile,
/area/rogue/under/tomb/indoors)
"IO" = (
/turf/closed/wall/mineral/decowood,
/area/rogue/under/tomb/indoors)
"IY" = (
/obj/structure/stairs/d,
/turf/open/floor/ruinedwood/spiral,
/area/rogue/under/tomb/indoors)
"Jc" = (
/obj/effect/decal/cleanable/sigil/SE,
/turf/open/floor/ruinedwood/spiral,
/area/rogue/under/tomb/indoors)
"Jk" = (
/obj/structure/door/fancy,
/obj/effect/mapping_helpers/door/locker,
/obj/item/soap/bath{
	pixel_y = -5
	},
/turf/open/floor/ruinedwood/spiral,
/area/rogue/under/tomb/indoors)
"Ju" = (
/obj/effect/dungeon_directional_helper/west,
/turf/open/floor/dirt,
/area/rogue/under/tomb/cave/wet)
"Kv" = (
/obj/structure/table/vtable,
/obj/item/weapon/knife/dagger/silver{
	pixel_y = 8;
	pixel_x = 6
	},
/turf/open/floor/ruinedwood/spiral,
/area/rogue/under/tomb/indoors)
"Lb" = (
/turf/open/floor/rooftop{
	dir = 8
	},
/area/rogue/under/tomb/cave/wet)
"Lu" = (
/turf/open/floor/dirt,
/area/rogue/under/tomb/cave/wet)
"Lv" = (
/mob/living/carbon/human/species/skeleton/npc/ambush,
/turf/open/floor/tile,
/area/rogue/under/tomb/indoors)
"MB" = (
/obj/effect/decal/cleanable/sigil/E,
/turf/open/floor/ruinedwood/spiral,
/area/rogue/under/tomb/indoors)
"MR" = (
/obj/effect/dungeon_directional_helper/east,
/turf/open/floor/dirt,
/area/rogue/under/tomb/cave/wet)
"OG" = (
/turf/open/floor/rooftop{
	dir = 4
	},
/area/rogue/under/tomb/cave/wet)
"PJ" = (
/obj/item/soap/bath{
	pixel_y = -5
	},
/mob/living/carbon/human/species/skeleton/npc/ambush,
/turf/open/water/bath,
/area/rogue/under/tomb/indoors)
"TJ" = (
/obj/structure/bed/shit,
/turf/open/floor/ruinedwood/spiral,
/area/rogue/under/tomb/indoors)
"Ve" = (
/turf/closed/mineral/bedrock,
/area/rogue/under/tomb/cave/wet)
"Vq" = (
/obj/structure/table/vtable/v2,
/obj/item/weapon/knife/dagger/silver{
	pixel_y = 3;
	pixel_x = -3
	},
/obj/item/reagent_containers/powder/moondust,
/obj/item/reagent_containers/powder/moondust{
	pixel_y = 10;
	pixel_x = -13
	},
/obj/item/reagent_containers/powder/moondust{
	pixel_y = 10;
	pixel_x = 10
	},
/turf/open/floor/ruinedwood/spiral,
/area/rogue/under/tomb/indoors)
"VJ" = (
/obj/item/gem/violet,
/turf/open/water/bath,
/area/rogue/under/tomb/indoors)
"VX" = (
/obj/effect/dungeon_directional_helper/south,
/turf/open/floor/dirt,
/area/rogue/under/tomb/cave/wet)
"Wi" = (
/obj/effect/decal/cleanable/sigil/N,
/obj/machinery/light/fueled/wallfire/candle/blue,
/turf/open/floor/ruinedwood/spiral,
/area/rogue/under/tomb/indoors)
"Wp" = (
/obj/structure/bed/shit,
/obj/item/statue/iron/deformed,
/turf/open/floor/ruinedwood/spiral,
/area/rogue/under/tomb/indoors)
"ZM" = (
/obj/structure/closet/crate/crafted_closet/inn,
/obj/item/statue/silver,
/turf/open/floor/ruinedwood/spiral,
/area/rogue/under/tomb/indoors)

(1,1,1) = {"
Ve
Ve
Ve
Ve
Ve
Ve
Ve
Ve
Ve
Ju
Lu
Ve
Ve
Ve
Ve
Ve
Ve
Ve
Ve
Ve
"}
(2,1,1) = {"
Ve
Lu
Lu
Lu
Lu
Lu
Lu
Lu
Lu
Lu
Lu
Lu
Lu
Lu
Lu
Lu
Lu
Lu
Lu
Ve
"}
(3,1,1) = {"
Ve
Lu
xf
xf
xf
xf
xf
xf
xf
xf
xf
xf
xf
xf
xf
xf
xf
xf
Lu
Ve
"}
(4,1,1) = {"
Ve
Lu
xf
la
la
la
la
la
la
xf
xf
la
la
la
la
la
la
xf
Lu
Ve
"}
(5,1,1) = {"
Ve
Lu
xf
la
nN
nN
yA
Gx
GE
xf
xf
GE
Gx
yA
nN
nN
la
xf
Lu
Ve
"}
(6,1,1) = {"
Ve
Lu
xf
la
PJ
nN
nN
Gx
la
xf
xf
la
pC
nN
nN
nN
la
xf
Lu
Ve
"}
(7,1,1) = {"
Ve
Lu
xf
la
Ae
nN
nN
jr
la
xf
xf
la
Gx
nN
PJ
nN
la
xf
Lu
Ve
"}
(8,1,1) = {"
Ve
Lu
xf
la
Gx
Gx
Gx
Gx
la
xf
xf
la
Gx
Gx
Gx
Gx
la
xf
Lu
Ve
"}
(9,1,1) = {"
Ve
Lu
xf
la
hp
la
la
la
Gx
Lv
Gx
Gx
la
la
la
hp
la
xf
Lu
Ve
"}
(10,1,1) = {"
Lu
Lu
xf
xf
xf
xf
gX
xf
Gx
wp
la
Gx
bx
bx
bx
bx
bx
xf
Lu
Lu
"}
(11,1,1) = {"
Ft
Lu
xf
xf
xf
xf
xf
xf
Gx
wp
la
Gx
bx
kT
bx
bx
bx
xf
Lu
VX
"}
(12,1,1) = {"
Ve
Lu
xf
la
GE
la
la
la
Gx
Gx
Gx
Gx
la
la
la
GE
la
xf
Lu
Ve
"}
(13,1,1) = {"
Ve
Lu
xf
la
Gx
Gx
Gx
Gx
la
xf
xf
la
Gx
Gx
Gx
Gx
la
xf
Lu
Ve
"}
(14,1,1) = {"
Ve
Lu
xf
la
Ae
nN
yA
Gx
la
xf
xf
la
pC
nN
nN
yA
la
xf
Lu
Ve
"}
(15,1,1) = {"
Ve
Lu
xf
la
nN
nN
lc
Gx
la
xf
xf
la
Gx
yA
nN
lc
la
xf
Lu
Ve
"}
(16,1,1) = {"
Ve
Lu
xf
la
nN
nN
nN
Gx
hp
xf
xf
hp
Gx
nN
lc
VJ
la
xf
Lu
Ve
"}
(17,1,1) = {"
Ve
Lu
xf
la
la
la
la
la
la
xf
xf
la
la
la
la
la
la
xf
Lu
Ve
"}
(18,1,1) = {"
Ve
Lu
xf
xf
xf
xf
xf
xf
xf
xf
xf
xf
xf
xf
xf
xf
xf
xf
Lu
Ve
"}
(19,1,1) = {"
Ve
Lu
Lu
Lu
Lu
Lu
Lu
Lu
Lu
Lu
Lu
Lu
Lu
Lu
Lu
Lu
Lu
Lu
Lu
Ve
"}
(20,1,1) = {"
Ve
Ve
Ve
Ve
Ve
Ve
Ve
Ve
Ve
MR
Lu
Ve
Ve
Ve
Ve
Ve
Ve
Ve
Ve
Ve
"}

(1,1,2) = {"
Ve
Ve
Ve
Ve
Ve
Ve
Ve
Ve
Cj
Cj
Cj
Cj
Ve
Ve
Ve
Ve
Ve
Ve
Ve
Ve
"}
(2,1,2) = {"
Ve
jl
jl
jl
jl
jl
jl
jl
jl
jl
jl
jl
jl
jl
jl
jl
jl
jl
jl
Ve
"}
(3,1,2) = {"
Ve
jl
jl
Lb
Lb
Lb
Lb
Lb
Lb
Lb
Lb
Lb
Lb
Lb
Lb
Lb
Lb
jl
jl
Ve
"}
(4,1,2) = {"
Ve
jl
BV
IO
IO
IO
IO
IO
IO
IO
IO
IO
IO
IO
IO
IO
IO
AV
jl
Ve
"}
(5,1,2) = {"
Ve
jl
BV
IO
pT
br
Wp
IO
io
xg
qz
Kv
IO
pe
oM
br
IO
AV
jl
Ve
"}
(6,1,2) = {"
Ve
jl
BV
IO
At
zF
TJ
IO
Wi
db
lp
qr
IO
Aj
br
br
IO
AV
jl
Ve
"}
(7,1,2) = {"
Ve
jl
BV
IO
hm
br
TJ
IO
FD
MB
Jc
br
IO
rx
br
br
IO
AV
jl
Ve
"}
(8,1,2) = {"
Ve
jl
BV
IO
br
br
zF
IO
br
br
br
br
IO
BP
br
br
IO
AV
jl
Ve
"}
(9,1,2) = {"
Cj
jl
BV
IO
IO
sj
IO
IO
br
br
br
br
IO
IO
Jk
IO
IO
AV
jl
Cj
"}
(10,1,2) = {"
Cj
jl
BV
ke
br
br
br
br
br
sV
IY
br
Av
gZ
br
br
ke
AV
jl
Cj
"}
(11,1,2) = {"
Cj
jl
BV
ke
br
br
br
br
br
sV
IY
br
br
fs
br
br
ke
AV
jl
Cj
"}
(12,1,2) = {"
Cj
jl
BV
IO
IO
gO
IO
IO
br
br
br
br
IO
IO
gO
IO
IO
AV
jl
Cj
"}
(13,1,2) = {"
Ve
jl
BV
IO
uG
br
br
IO
br
br
br
br
IO
Av
br
br
IO
AV
jl
Ve
"}
(14,1,2) = {"
Ve
jl
BV
IO
br
br
br
IO
rF
br
br
br
IO
ZM
br
br
IO
AV
jl
Ve
"}
(15,1,2) = {"
Ve
jl
BV
IO
sz
br
br
IO
Vq
br
br
br
IO
fv
br
Av
IO
AV
jl
Ve
"}
(16,1,2) = {"
Ve
jl
BV
IO
dL
br
Fz
IO
uG
br
br
br
IO
dL
br
br
IO
AV
jl
Ve
"}
(17,1,2) = {"
Ve
jl
BV
IO
IO
IO
IO
IO
IO
IO
IO
IO
IO
IO
IO
IO
IO
AV
jl
Ve
"}
(18,1,2) = {"
Ve
jl
jl
OG
OG
OG
OG
OG
OG
OG
OG
OG
OG
OG
OG
OG
OG
jl
jl
Ve
"}
(19,1,2) = {"
Ve
jl
jl
jl
jl
jl
jl
jl
jl
jl
jl
jl
jl
jl
jl
jl
jl
jl
jl
Ve
"}
(20,1,2) = {"
Ve
Ve
Ve
Ve
Ve
Ve
Ve
Ve
Cj
Cj
Cj
Cj
Ve
Ve
Ve
Ve
Ve
Ve
Ve
Ve
"}
