//MAP CONVERTED BY dmm2tgm.py THIS HEADER COMMENT PREVENTS RECONVERSION, DO NOT REMOVE
"aq" = (
/obj/structure/table/wood/large/corner_alt,
/obj/item/reagent_containers/food/snacks/rotten/sausage{
	pixel_y = 4
	},
/turf/open/floor/ruinedwood/spiralfade,
/area/rogue/under/tomb/indoors)
"bn" = (
/obj/structure/window/openclose,
/turf/open/floor/ruinedwood/spiralfade,
/area/rogue/under/tomb/indoors)
"ca" = (
/turf/open/floor/ruinedwood/spiralfade,
/area/rogue/under/tomb/indoors)
"cs" = (
/obj/structure/door,
/obj/item/restraints/legcuffs/beartrap/armed,
/turf/open/floor/ruinedwood/spiralfade,
/area/rogue/under/tomb/indoors)
"cB" = (
/obj/structure/chair/stool{
	pixel_x = -5
	},
/turf/open/floor/ruinedwood/spiralfade,
/area/rogue/under/tomb/indoors)
"cH" = (
/obj/structure/toilet,
/mob/living/carbon/human/species/orc/npc,
/obj/effect/mapping_helpers/outfit_handler{
	outfit_to_equip = /datum/outfit/job/adventurer/barbarian
	},
/turf/open/floor/ruinedwood/spiralfade,
/area/rogue/under/tomb/indoors)
"cY" = (
/obj/structure/chair/wood{
	dir = 4
	},
/turf/open/floor/ruinedwood/spiralfade,
/area/rogue/under/tomb/indoors)
"da" = (
/obj/structure/table/wood/large_alt,
/obj/item/reagent_containers/glass/cup/wooden/crafted{
	pixel_x = 9
	},
/turf/open/floor/ruinedwood/spiralfade,
/area/rogue/under/tomb/indoors)
"dC" = (
/turf/open/floor/dirt,
/area/rogue/under/tomb/indoors)
"eu" = (
/obj/machinery/light/fueled/torchholder/l,
/turf/open/floor/ruinedwood/spiralfade,
/area/rogue/under/tomb/indoors)
"ev" = (
/obj/item/reagent_containers/powder/moondust{
	pixel_x = 5
	},
/obj/item/reagent_containers/powder/moondust{
	pixel_y = -5;
	pixel_x = -13
	},
/obj/item/reagent_containers/powder/moondust{
	pixel_y = 12;
	pixel_x = -7
	},
/obj/effect/decal/cleanable/blood,
/obj/item/weapon/knife/hunting{
	pixel_y = -2;
	pixel_x = -14
	},
/turf/open/floor/ruinedwood/spiralfade,
/area/rogue/under/tomb/indoors)
"eJ" = (
/obj/effect/dungeon_directional_helper/east,
/turf/open/floor/naturalstone,
/area/rogue/under/tomb)
"eU" = (
/obj/structure/bed/inn,
/turf/open/floor/ruinedwood/spiralfade,
/area/rogue/under/tomb/indoors)
"gZ" = (
/obj/structure/chair/bench/couch/redright,
/turf/open/floor/ruinedwood/spiralfade,
/area/rogue/under/tomb/indoors)
"hi" = (
/turf/open/transparent/openspace,
/area/rogue/under/tomb/indoors)
"hZ" = (
/obj/structure/well,
/turf/open/floor/dirt,
/area/rogue/under/tomb)
"iM" = (
/obj/structure/window,
/obj/structure/fluff/walldeco/vinez,
/turf/open/floor/ruinedwood/spiralfade,
/area/rogue/under/tomb/indoors)
"iN" = (
/obj/structure/fluff/railing/border{
	dir = 1
	},
/turf/open/floor/ruinedwood/spiralfade,
/area/rogue/under/tomb/indoors)
"iS" = (
/obj/structure/chair/stool,
/turf/open/floor/ruinedwood/spiralfade,
/area/rogue/under/tomb/indoors)
"jC" = (
/obj/structure/fluff/walldeco/bath/wallpipes,
/turf/open/floor/ruinedwood/spiralfade,
/area/rogue/under/tomb/indoors)
"kr" = (
/obj/effect/dungeon_directional_helper/south,
/turf/open/floor/naturalstone,
/area/rogue/under/tomb)
"lb" = (
/obj/structure/table/wood/plain,
/obj/item/weapon/knife/cleaver,
/obj/structure/fluff/walldeco/bigpainting/lake,
/turf/open/floor/ruinedwood/spiralfade,
/area/rogue/under/tomb/indoors)
"lc" = (
/obj/structure/table/wood/large/corner_alt,
/turf/open/floor/ruinedwood/spiralfade,
/area/rogue/under/tomb/indoors)
"ll" = (
/turf/open/floor/rooftop/green{
	dir = 1
	},
/area/rogue/under/tomb)
"lr" = (
/obj/structure/chair/wood,
/turf/open/floor/ruinedwood/spiralfade,
/area/rogue/under/tomb/indoors)
"lC" = (
/obj/structure/closet/crate/crafted_closet/inn/south,
/turf/open/floor/ruinedwood/spiralfade,
/area/rogue/under/tomb/indoors)
"lH" = (
/turf/closed/mineral/bedrock,
/area/rogue/under/tomb)
"lK" = (
/obj/machinery/light/fueled/hearth,
/obj/item/reagent_containers/glass/bucket/pot,
/turf/open/floor/ruinedwood/spiralfade,
/area/rogue/under/tomb/indoors)
"oa" = (
/obj/structure/table/wood/counter{
	dir = 4
	},
/obj/item/reagent_containers/glass/cup/wooden/crafted{
	pixel_x = -6;
	pixel_y = 16
	},
/obj/item/reagent_containers/glass/cup/wooden/crafted{
	pixel_y = -8
	},
/obj/item/reagent_containers/glass/cup/wooden/crafted{
	pixel_x = 4;
	pixel_y = 14
	},
/turf/open/floor/ruinedwood/spiralfade,
/area/rogue/under/tomb/indoors)
"ob" = (
/obj/structure/table/wood/large/corner_alt,
/obj/item/reagent_containers/glass/cup/wooden/crafted{
	pixel_x = -6;
	pixel_y = 16
	},
/turf/open/floor/ruinedwood/spiralfade,
/area/rogue/under/tomb/indoors)
"ov" = (
/obj/structure/fluff/railing/border{
	dir = 10
	},
/turf/open/floor/ruinedwood/spiralfade,
/area/rogue/under/tomb/indoors)
"pc" = (
/obj/machinery/light/fueled/chand,
/obj/item/clothing/ring/silver,
/turf/open/transparent/openspace,
/area/rogue/under/tomb/indoors)
"qy" = (
/obj/structure/fluff/walldeco/vinez,
/obj/structure/window,
/turf/open/floor/ruinedwood/spiralfade,
/area/rogue/under/tomb/indoors)
"qD" = (
/obj/effect/dungeon_directional_helper/north,
/turf/open/floor/naturalstone,
/area/rogue/under/tomb)
"qX" = (
/obj/machinery/light/fueled/hearth,
/obj/item/cooking/pan,
/turf/open/floor/ruinedwood/spiralfade,
/area/rogue/under/tomb/indoors)
"qY" = (
/obj/structure/table/wood/plain,
/obj/item/reagent_containers/glass/bottle/wine/sourwine{
	pixel_y = 9
	},
/obj/item/reagent_containers/glass/bottle/wine/sourwine{
	pixel_y = 5;
	pixel_x = -7
	},
/obj/item/reagent_containers/glass/bottle/poison{
	pixel_y = 7;
	pixel_x = 8
	},
/turf/open/floor/ruinedwood/spiralfade,
/area/rogue/under/tomb/indoors)
"qZ" = (
/turf/closed/wall/mineral/stone/moss,
/area/rogue/under/tomb)
"ri" = (
/obj/structure/fluff/walldeco/vinez,
/turf/closed/wall/mineral/decowood/vert,
/area/rogue/under/tomb/indoors)
"ub" = (
/obj/structure/fluff/walldeco/sign/trophy,
/turf/open/floor/ruinedwood/spiralfade,
/area/rogue/under/tomb/indoors)
"vm" = (
/obj/structure/fluff/walldeco/vinez/l,
/turf/open/floor/ruinedwood/spiralfade,
/area/rogue/under/tomb/indoors)
"vB" = (
/obj/structure/bars/pipe/left,
/mob/living/carbon/human/species/skeleton/npc/ambush,
/turf/open/water/bath,
/area/rogue/under/tomb/indoors)
"vL" = (
/obj/structure/fluff/railing/border{
	dir = 6
	},
/turf/open/floor/ruinedwood/spiralfade,
/area/rogue/under/tomb/indoors)
"wn" = (
/obj/machinery/light/fueled/oven/west,
/turf/open/floor/ruinedwood/spiralfade,
/area/rogue/under/tomb/indoors)
"wE" = (
/turf/closed/wall/mineral/stone/moss,
/area/rogue/under/tomb/indoors)
"xb" = (
/obj/effect/dungeon_directional_helper/west,
/turf/open/floor/naturalstone,
/area/rogue/under/tomb)
"ye" = (
/obj/structure/fluff/railing/border{
	dir = 4
	},
/obj/structure/fluff/railing/border{
	dir = 4
	},
/turf/open/floor/ruinedwood/spiralfade,
/area/rogue/under/tomb/indoors)
"yA" = (
/obj/structure/fluff/walldeco/vinez/r,
/turf/open/floor/ruinedwood/spiralfade,
/area/rogue/under/tomb/indoors)
"yL" = (
/obj/structure/fluff/walldeco/painting/queen,
/turf/closed/wall/mineral/stone/moss,
/area/rogue/under/tomb/indoors)
"zx" = (
/obj/structure/fluff/railing/border,
/obj/structure/fluff/railing/border,
/turf/open/floor/ruinedwood/spiralfade,
/area/rogue/under/tomb/indoors)
"zF" = (
/obj/structure/floordoor/gatehatch/inner,
/turf/open/floor/dirt,
/area/rogue/under/tomb)
"Af" = (
/obj/structure/fluff/walldeco/vinez/offset,
/turf/open/floor/ruinedwood/spiralfade,
/area/rogue/under/tomb/indoors)
"AK" = (
/obj/structure/fluff/railing/border{
	dir = 8
	},
/turf/open/floor/ruinedwood/spiralfade,
/area/rogue/under/tomb/indoors)
"AP" = (
/obj/machinery/light/fueled/chand,
/turf/open/transparent/openspace,
/area/rogue/under/tomb/indoors)
"Ba" = (
/obj/structure/rack/shelf/biggest,
/obj/item/reagent_containers/food/snacks/meat/salami{
	pixel_y = -2;
	pixel_x = -1
	},
/obj/item/reagent_containers/food/snacks/meat/salami{
	pixel_x = -2;
	pixel_y = 10
	},
/turf/open/floor/ruinedwood/spiralfade,
/area/rogue/under/tomb/indoors)
"BA" = (
/obj/structure/fluff/railing/border{
	dir = 9
	},
/turf/open/floor/ruinedwood/spiralfade,
/area/rogue/under/tomb/indoors)
"CE" = (
/obj/structure/window/openclose{
	dir = 4
	},
/turf/open/floor/ruinedwood/spiralfade,
/area/rogue/under/tomb/indoors)
"CT" = (
/obj/machinery/light/fueled/wallfire{
	pixel_x = 16
	},
/turf/closed/wall/mineral/decowood/vert,
/area/rogue/under/tomb/indoors)
"Ee" = (
/obj/structure/closet/crate/crafted_closet/inn,
/turf/open/floor/ruinedwood/spiralfade,
/area/rogue/under/tomb/indoors)
"Eu" = (
/obj/structure/table/wood/counter{
	dir = 4
	},
/turf/open/floor/ruinedwood/spiralfade,
/area/rogue/under/tomb/indoors)
"EU" = (
/obj/structure/fluff/railing/border{
	dir = 4
	},
/turf/open/floor/ruinedwood/spiralfade,
/area/rogue/under/tomb/indoors)
"Fl" = (
/obj/structure/bed/bear{
	pixel_x = 0;
	pixel_y = -6
	},
/turf/open/floor/ruinedwood/spiralfade,
/area/rogue/under/tomb/indoors)
"Gd" = (
/obj/structure/chair/stool{
	pixel_x = 3;
	pixel_y = -1
	},
/turf/open/floor/ruinedwood/spiralfade,
/area/rogue/under/tomb/indoors)
"Hg" = (
/obj/structure/closet/crate/drawer/inn,
/turf/open/floor/ruinedwood/spiralfade,
/area/rogue/under/tomb/indoors)
"Hr" = (
/turf/closed/wall/mineral/decowood/vert,
/area/rogue/under/tomb/indoors)
"HJ" = (
/obj/structure/door,
/turf/open/floor/ruinedwood/spiralfade,
/area/rogue/under/tomb/indoors)
"HL" = (
/turf/open/floor/naturalstone,
/area/rogue/under/tomb)
"Jh" = (
/obj/structure/fluff/railing/border,
/turf/open/floor/ruinedwood/spiralfade,
/area/rogue/under/tomb/indoors)
"JF" = (
/obj/item/soap/bath,
/turf/open/water/bath,
/area/rogue/under/tomb/indoors)
"Kk" = (
/obj/structure/table/wood/large_alt,
/obj/item/reagent_containers/glass/cup/wooden/crafted{
	pixel_y = -5;
	pixel_x = 13
	},
/turf/open/floor/ruinedwood/spiralfade,
/area/rogue/under/tomb/indoors)
"Kl" = (
/turf/open/floor/naturalstone,
/area/rogue/under/tomb/indoors)
"KS" = (
/obj/structure/fluff/walldeco/sign/saiga,
/turf/open/floor/dirt,
/area/rogue/under/tomb)
"Le" = (
/obj/structure/window/openclose{
	dir = 8
	},
/turf/open/floor/ruinedwood/spiralfade,
/area/rogue/under/tomb/indoors)
"Lh" = (
/turf/open/transparent/openspace,
/area/rogue/under/tomb)
"Lr" = (
/obj/structure/door/weak/bolt{
	dir = 1
	},
/obj/item/soap,
/turf/open/floor/ruinedwood/spiralfade,
/area/rogue/under/tomb/indoors)
"LG" = (
/turf/open/floor/rooftop/green{
	dir = 4
	},
/area/rogue/under/tomb)
"ML" = (
/turf/closed/wall/mineral/decowood,
/area/rogue/under/tomb/indoors)
"NN" = (
/turf/open/floor/dirt,
/area/rogue/under/tomb)
"OR" = (
/obj/structure/window,
/turf/open/floor/ruinedwood/spiralfade,
/area/rogue/under/tomb/indoors)
"OW" = (
/obj/machinery/light/fueled/torchholder/r,
/turf/open/floor/ruinedwood/spiralfade,
/area/rogue/under/tomb/indoors)
"PB" = (
/obj/item/chair/stool/bar,
/turf/open/floor/ruinedwood/spiralfade,
/area/rogue/under/tomb/indoors)
"PR" = (
/obj/effect/mapping_helpers/outfit_handler{
	outfit_to_equip = /datum/outfit/job/adventurer/barbarian
	},
/mob/living/carbon/human/species/orc/npc,
/turf/open/floor/ruinedwood/spiralfade,
/area/rogue/under/tomb/indoors)
"Qk" = (
/obj/structure/bed/inn/double,
/turf/open/floor/ruinedwood/spiralfade,
/area/rogue/under/tomb/indoors)
"QF" = (
/obj/structure/rack/shelf/big,
/turf/open/floor/ruinedwood/spiralfade,
/area/rogue/under/tomb/indoors)
"So" = (
/obj/structure/stairs/d{
	dir = 4
	},
/turf/open/floor/ruinedwood/spiralfade,
/area/rogue/under/tomb/indoors)
"Sr" = (
/obj/structure/door/window,
/turf/open/floor/ruinedwood/spiralfade,
/area/rogue/under/tomb/indoors)
"SI" = (
/turf/open/water/bath,
/area/rogue/under/tomb/indoors)
"Tz" = (
/turf/open/floor/rooftop/green{
	dir = 8
	},
/area/rogue/under/tomb)
"TD" = (
/obj/structure/fermentation_keg/random/beer,
/turf/open/floor/ruinedwood/spiralfade,
/area/rogue/under/tomb/indoors)
"Ua" = (
/obj/structure/closet/crate/crafted_closet/inn/chest,
/turf/open/floor/ruinedwood/spiralfade,
/area/rogue/under/tomb/indoors)
"UM" = (
/obj/structure/window/openclose{
	dir = 1
	},
/turf/open/floor/ruinedwood/spiralfade,
/area/rogue/under/tomb/indoors)
"UO" = (
/turf/open/floor/rooftop/green,
/area/rogue/under/tomb)
"WV" = (
/obj/structure/fluff/railing/border{
	dir = 5
	},
/turf/open/floor/ruinedwood/spiralfade,
/area/rogue/under/tomb/indoors)
"XM" = (
/obj/structure/chair/bench/couch/redleft,
/turf/open/floor/ruinedwood/spiralfade,
/area/rogue/under/tomb/indoors)
"Ya" = (
/obj/machinery/light/fueled/torchholder/l,
/obj/structure/fluff/walldeco/vinez/l,
/turf/open/floor/ruinedwood/spiralfade,
/area/rogue/under/tomb/indoors)
"YY" = (
/mob/living/carbon/human/species/skeleton/npc/ambush,
/turf/open/water/bath,
/area/rogue/under/tomb/indoors)

(1,1,1) = {"
lH
lH
lH
lH
lH
lH
lH
lH
lH
xb
HL
lH
lH
lH
lH
lH
lH
lH
lH
lH
"}
(2,1,1) = {"
lH
HL
HL
NN
NN
NN
NN
NN
NN
HL
HL
NN
NN
NN
NN
NN
NN
NN
NN
lH
"}
(3,1,1) = {"
lH
HL
HL
NN
NN
NN
NN
NN
KS
HL
HL
NN
KS
NN
NN
NN
zF
NN
HL
lH
"}
(4,1,1) = {"
lH
HL
HL
wE
wE
wE
CE
wE
wE
Sr
Sr
wE
wE
CE
wE
wE
wE
NN
HL
lH
"}
(5,1,1) = {"
lH
NN
NN
wE
XM
lc
PB
ca
Hr
ca
ca
ca
ca
ca
ca
ca
wE
NN
NN
lH
"}
(6,1,1) = {"
lH
HL
NN
wE
gZ
lc
iS
ca
CT
cB
Fl
ca
lr
Kk
aq
ca
wE
NN
NN
lH
"}
(7,1,1) = {"
lH
HL
NN
bn
ca
ca
Kl
ca
Hr
Gd
ca
ca
ca
da
ob
ca
UM
NN
HL
lH
"}
(8,1,1) = {"
lH
NN
NN
wE
ML
ML
ML
ca
Hr
ub
ca
ca
ca
ca
cY
ca
UM
NN
NN
lH
"}
(9,1,1) = {"
lH
NN
NN
yL
ca
ca
ca
ca
ca
dC
dC
ca
ca
ca
ca
ca
wE
NN
HL
lH
"}
(10,1,1) = {"
HL
HL
HL
Sr
dC
ca
ca
ca
ca
dC
ca
ca
ca
ca
ca
ca
Sr
HL
HL
HL
"}
(11,1,1) = {"
qD
HL
HL
Sr
ca
ca
ca
ca
ca
ca
ca
iS
PB
iS
ca
ca
Sr
HL
HL
kr
"}
(12,1,1) = {"
lH
NN
HL
wE
ca
ca
ca
wE
wE
cs
wE
oa
Eu
Eu
Eu
Eu
wE
NN
NN
lH
"}
(13,1,1) = {"
lH
NN
NN
bn
ca
dC
ca
wE
Ua
ca
wE
QF
ca
ca
ca
TD
wE
NN
hZ
lH
"}
(14,1,1) = {"
lH
HL
NN
wE
So
So
ca
wE
Ua
PR
wE
lb
ca
ca
ca
TD
UM
NN
NN
lH
"}
(15,1,1) = {"
lH
NN
NN
wE
wE
wE
ca
wE
Ba
ca
wE
qY
ca
ca
ca
ca
UM
NN
HL
lH
"}
(16,1,1) = {"
lH
NN
NN
wE
wE
wE
HJ
wE
Ee
ca
HJ
ca
wn
wn
qX
lK
wE
NN
NN
lH
"}
(17,1,1) = {"
lH
NN
NN
wE
wE
cH
ca
wE
wE
wE
wE
wE
wE
wE
wE
Le
wE
NN
NN
lH
"}
(18,1,1) = {"
lH
NN
NN
NN
qZ
qZ
qZ
qZ
NN
NN
NN
HL
NN
NN
NN
NN
NN
NN
NN
lH
"}
(19,1,1) = {"
lH
NN
NN
NN
NN
NN
NN
NN
HL
HL
NN
NN
NN
HL
NN
NN
HL
NN
NN
lH
"}
(20,1,1) = {"
lH
lH
lH
lH
lH
lH
lH
lH
eJ
HL
lH
lH
lH
lH
lH
lH
lH
lH
lH
lH
"}

(1,1,2) = {"
lH
lH
lH
lH
lH
lH
lH
lH
lH
Lh
Lh
lH
lH
lH
lH
lH
lH
lH
lH
lH
"}
(2,1,2) = {"
lH
Lh
Lh
Lh
Lh
Lh
Lh
Lh
Lh
Lh
Lh
Lh
Lh
Lh
Lh
Lh
Lh
Lh
Lh
lH
"}
(3,1,2) = {"
lH
Lh
Lh
Tz
Tz
Tz
Tz
Tz
Tz
Tz
Tz
Tz
Tz
Tz
Tz
Tz
Tz
Lh
Lh
lH
"}
(4,1,2) = {"
lH
Lh
ll
wE
ML
ML
OR
Hr
ML
OR
Hr
ML
ML
Hr
ML
OR
wE
UO
Lh
lH
"}
(5,1,2) = {"
lH
Lh
ll
Hr
lC
ca
ca
Hr
Hg
vm
Hr
Hg
ca
Hr
Hg
vm
Hr
UO
Lh
lH
"}
(6,1,2) = {"
lH
Lh
ll
Hr
Qk
Hg
ca
Hr
eU
ca
Hr
eU
hi
Hr
eU
ca
Hr
UO
Lh
lH
"}
(7,1,2) = {"
lH
Lh
ll
Hr
ML
ML
HJ
Hr
ML
HJ
Hr
ML
HJ
Hr
ML
HJ
Hr
UO
Lh
lH
"}
(8,1,2) = {"
lH
Lh
ll
Hr
ca
Ya
vL
EU
EU
EU
EU
ye
EU
WV
eu
ca
Hr
UO
Lh
lH
"}
(9,1,2) = {"
lH
Lh
ll
Hr
ca
hi
Jh
hi
hi
hi
hi
hi
hi
iN
hi
ca
ri
UO
Lh
lH
"}
(10,1,2) = {"
Lh
Lh
ll
ri
ca
ca
zx
hi
pc
hi
hi
AP
hi
iN
ca
hi
qy
UO
Lh
Lh
"}
(11,1,2) = {"
Lh
Lh
ll
Hr
Af
ca
hi
hi
hi
hi
hi
hi
hi
iN
ca
ca
Hr
UO
Lh
Lh
"}
(12,1,2) = {"
lH
Lh
ll
ri
hi
ca
ov
AK
AK
AK
AK
AK
AK
BA
ca
ca
Hr
UO
Lh
lH
"}
(13,1,2) = {"
lH
Lh
ll
Hr
ca
ca
ca
Hr
ML
ML
HJ
Hr
Hr
Hr
Hr
Hr
Hr
UO
Lh
lH
"}
(14,1,2) = {"
lH
Lh
ll
Hr
hi
hi
ca
Hr
Qk
ca
ca
Hr
lC
ca
YY
SI
Hr
UO
Lh
lH
"}
(15,1,2) = {"
lH
Lh
ll
Hr
So
So
ca
Hr
ca
ca
ca
Hr
jC
ev
SI
JF
iM
UO
Lh
lH
"}
(16,1,2) = {"
lH
Lh
ll
Hr
OW
yA
yA
Hr
lC
ca
ca
Lr
ca
ca
vB
SI
Hr
UO
Lh
lH
"}
(17,1,2) = {"
lH
Lh
ll
wE
ML
ML
ML
ML
ML
OR
ML
ML
ML
ML
ML
ML
wE
UO
Lh
lH
"}
(18,1,2) = {"
lH
Lh
Lh
LG
LG
LG
LG
LG
LG
LG
LG
LG
LG
LG
LG
LG
LG
Lh
Lh
lH
"}
(19,1,2) = {"
lH
Lh
Lh
Lh
Lh
Lh
Lh
Lh
Lh
Lh
Lh
Lh
Lh
Lh
Lh
Lh
Lh
Lh
Lh
lH
"}
(20,1,2) = {"
lH
lH
lH
lH
lH
lH
lH
lH
Lh
Lh
lH
lH
lH
lH
lH
lH
lH
lH
lH
lH
"}
