//MAP CONVERTED BY dmm2tgm.py THIS HEADER COMMENT PREVENTS RECONVERSION, DO NOT REMOVE
"aa" = (
/turf/closed/mineral/bedrock,
/area/rogue/under/cave)
"ab" = (
/obj/structure/bars,
/turf/open/floor/hexstone,
/area/rogue/under/tomb)
"ac" = (
/obj/structure/closet/dirthole/closed/loot,
/turf/open/floor/dirt,
/area/rogue/under/cave)
"ad" = (
/mob/living/carbon/human/species/skeleton/npc/warrior/skilled,
/turf/open/floor/hexstone,
/area/rogue/under/cave)
"ae" = (
/turf/open/floor/dirt,
/area/rogue/under/cave)
"af" = (
/obj/structure/plasticflaps,
/turf/open/floor/hexstone,
/area/rogue/under/tomb)
"ag" = (
/mob/living/carbon/human/species/skeleton/npc/ambush,
/turf/open/floor/hexstone,
/area/rogue/under/tomb)
"ah" = (
/turf/open/floor/dirt,
/area/rogue/under/tomb)
"ai" = (
/obj/structure/door/viewport{
	dir = 4
	},
/turf/open/floor/hexstone,
/area/rogue/under/tomb)
"aj" = (
/mob/living/carbon/human/species/skeleton/npc/warrior,
/turf/open/floor/hexstone,
/area/rogue/under/tomb)
"ak" = (
/obj/structure/closet/dirthole/closed/loot,
/mob/living/carbon/human/species/skeleton/npc/ambush,
/turf/open/floor/dirt,
/area/rogue/under/tomb)
"al" = (
/turf/closed/mineral/bedrock,
/area/rogue/under/tomb)
"am" = (
/obj/effect/spawner/map_spawner/loot,
/turf/open/floor/hexstone,
/area/rogue/under/cave)
"an" = (
/mob/living/carbon/human/species/skeleton/npc/warrior,
/turf/open/floor/hexstone,
/area/rogue/under/cave)
"ao" = (
/obj/item/statue/gold/loot,
/turf/open/floor/hexstone,
/area/rogue/under/cave)
"ap" = (
/turf/open/floor/hexstone,
/area/rogue/under/cave)
"aq" = (
/obj/effect/decal/cleanable/blood/tracks,
/turf/open/floor/hexstone,
/area/rogue/under/cave)
"ar" = (
/obj/effect/decal/cleanable/blood/gibs,
/obj/effect/decal/cleanable/blood,
/turf/open/floor/hexstone,
/area/rogue/under/cave)
"as" = (
/obj/structure/chair/bench/throne,
/mob/living/carbon/human/species/skeleton/npc/warrior/skilled,
/turf/open/floor/hexstone,
/area/rogue/under/cave)
"at" = (
/obj/effect/decal/cleanable/blood/gibs/core,
/turf/open/floor/hexstone,
/area/rogue/under/cave)
"au" = (
/obj/effect/decal/cleanable/blood/footprints{
	dir = 4
	},
/turf/open/floor/hexstone,
/area/rogue/under/cave)
"av" = (
/obj/effect/decal/cleanable/blood/gibs/down,
/turf/open/floor/hexstone,
/area/rogue/under/cave)
"aw" = (
/mob/living/carbon/human/species/skeleton/npc/ambush,
/turf/open/floor/dirt,
/area/rogue/under/cave)
"ax" = (
/turf/closed/wall/mineral/stone/moss,
/area/rogue/under/cave)
"ay" = (
/obj/effect/decal/cleanable/blood/gibs/up,
/turf/open/floor/hexstone,
/area/rogue/under/cave)
"az" = (
/obj/effect/decal/cleanable/blood,
/turf/open/floor/hexstone,
/area/rogue/under/cave)
"aA" = (
/obj/effect/spawner/map_spawner/loot/common,
/turf/open/floor/hexstone,
/area/rogue/under/cave)
"aB" = (
/obj/effect/dungeon_directional_helper/west,
/turf/open/floor/hexstone,
/area/rogue/under/cave)
"aC" = (
/obj/structure/table/wood/plain/alt,
/obj/item/storage/belt/leather/plaquegold,
/turf/open/floor/hexstone,
/area/rogue/under/cave)
"aD" = (
/obj/structure/closet/dirthole/closed/loot,
/turf/open/floor/dirt,
/area/rogue/under/tomb)
"aE" = (
/mob/living/carbon/human/species/skeleton/npc/ambush,
/turf/open/floor/hexstone,
/area/rogue/under/cave)
"aF" = (
/obj/structure/ladder,
/turf/open/floor/hexstone,
/area/rogue/under/cave)
"aG" = (
/obj/effect/decal/cleanable/blood/puddle,
/obj/effect/decal/cleanable/blood/splatter,
/turf/open/floor/hexstone,
/area/rogue/under/cave)
"aH" = (
/obj/structure/plasticflaps,
/turf/open/floor/hexstone,
/area/rogue/under/cave)
"aI" = (
/obj/effect/decal/cleanable/blood/footprints{
	dir = 8
	},
/turf/open/floor/hexstone,
/area/rogue/under/cave)
"aJ" = (
/mob/living/carbon/human/species/skeleton/npc/peasant,
/turf/open/floor/hexstone,
/area/rogue/under/cave)
"aK" = (
/obj/structure/closet/crate/coffin,
/turf/open/floor/dirt,
/area/rogue/under/cave)
"aL" = (
/obj/structure/table/wood/plain/alt,
/obj/item/storage/belt/leather/plaquegold,
/turf/open/floor/hexstone,
/area/rogue/under/tomb)
"aM" = (
/obj/effect/decal/cleanable/blood/footprints,
/turf/open/floor/hexstone,
/area/rogue/under/cave)
"aN" = (
/obj/effect/dungeon_directional_helper/west,
/turf/open/floor/hexstone,
/area/rogue/under/tomb)
"aO" = (
/obj/structure/ladder,
/turf/open/floor/hexstone,
/area/rogue/under/tomb)
"aP" = (
/mob/living/simple_animal/hostile/demon{
	name = "Bonetaker";
	base_constitution = 15;
	base_endurance = 15;
	base_intelligence = 15;
	base_fortune = 15;
	base_perception = 15;
	base_speed = 18;
	base_strength = 20
	},
/obj/effect/decal/cleanable/blood/gibs/up,
/turf/open/floor/hexstone,
/area/rogue/under/cave)
"aQ" = (
/obj/structure/closet/crate/coffin,
/mob/living/carbon/human/species/skeleton/npc/ambush,
/turf/open/floor/dirt,
/area/rogue/under/cave)
"aR" = (
/turf/closed/wall/mineral/stone/moss,
/area/rogue/under/tomb)
"aS" = (
/obj/effect/decal/cleanable/blood/gibs/limb,
/turf/open/floor/hexstone,
/area/rogue/under/cave)
"aT" = (
/obj/structure/bars/cemetery,
/turf/open/floor/hexstone,
/area/rogue/under/cave)
"aU" = (
/obj/structure/closet/dirthole/closed/loot,
/mob/living/carbon/human/species/skeleton/npc/ambush,
/turf/open/floor/dirt,
/area/rogue/under/cave)
"aV" = (
/obj/structure/door/viewport{
	dir = 4
	},
/obj/effect/mapping_helpers/door/locker,
/turf/open/floor/hexstone,
/area/rogue/under/cave)
"aW" = (
/obj/structure/table/wood/plain/alt,
/obj/item/reagent_containers/glass/cup/golden,
/turf/open/floor/hexstone,
/area/rogue/under/cave)
"aX" = (
/obj/structure/bars,
/turf/open/floor/hexstone,
/area/rogue/under/cave)
"aY" = (
/obj/structure/door/viewport{
	dir = 4
	},
/turf/open/floor/hexstone,
/area/rogue/under/cave)
"aZ" = (
/turf/open/floor/hexstone,
/area/rogue/under/tomb)
"bN" = (
/obj/structure/closet/crate/coffin,
/mob/living/carbon/human/species/skeleton/npc/ambush,
/turf/open/floor/dirt,
/area/rogue/under/tomb)
"ca" = (
/obj/effect/decal/cleanable/blood,
/turf/open/floor/hexstone,
/area/rogue/under/tomb)
"gq" = (
/obj/structure/closet/crate/coffin,
/turf/open/floor/dirt,
/area/rogue/under/tomb)
"je" = (
/obj/effect/decal/cleanable/blood/gibs/up,
/turf/open/floor/hexstone,
/area/rogue/under/tomb)
"jK" = (
/obj/structure/bars/cemetery,
/turf/open/floor/hexstone,
/area/rogue/under/tomb)
"jO" = (
/obj/effect/decal/cleanable/blood/tracks,
/turf/open/floor/hexstone,
/area/rogue/under/tomb)
"nk" = (
/obj/effect/decal/cleanable/blood/gibs,
/obj/effect/decal/cleanable/blood,
/turf/open/floor/hexstone,
/area/rogue/under/tomb)
"rX" = (
/obj/effect/decal/cleanable/blood/footprints{
	dir = 4
	},
/turf/open/floor/hexstone,
/area/rogue/under/tomb)
"ty" = (
/obj/effect/decal/cleanable/blood/puddle,
/obj/effect/decal/cleanable/blood/splatter,
/turf/open/floor/hexstone,
/area/rogue/under/tomb)
"vT" = (
/obj/effect/spawner/map_spawner/loot,
/turf/open/floor/hexstone,
/area/rogue/under/tomb)
"wd" = (
/obj/effect/decal/cleanable/blood/gibs/down,
/turf/open/floor/hexstone,
/area/rogue/under/tomb)
"yr" = (
/obj/item/statue/gold/loot,
/turf/open/floor/hexstone,
/area/rogue/under/tomb)
"zh" = (
/obj/structure/chair/bench/throne,
/mob/living/carbon/human/species/skeleton/npc/warrior/skilled,
/turf/open/floor/hexstone,
/area/rogue/under/tomb)
"CK" = (
/obj/structure/table/wood/plain/alt,
/obj/item/reagent_containers/glass/cup/golden,
/turf/open/floor/hexstone,
/area/rogue/under/tomb)
"Jl" = (
/obj/effect/decal/cleanable/blood/gibs/core,
/turf/open/floor/hexstone,
/area/rogue/under/tomb)
"LL" = (
/mob/living/carbon/human/species/skeleton/npc/peasant,
/turf/open/floor/hexstone,
/area/rogue/under/tomb)
"Ny" = (
/obj/effect/decal/cleanable/blood/footprints{
	dir = 8
	},
/turf/open/floor/hexstone,
/area/rogue/under/tomb)
"Pj" = (
/obj/effect/decal/cleanable/blood/gibs/limb,
/turf/open/floor/hexstone,
/area/rogue/under/tomb)
"PU" = (
/obj/effect/spawner/map_spawner/loot/common,
/turf/open/floor/hexstone,
/area/rogue/under/tomb)
"Qw" = (
/obj/effect/decal/cleanable/blood/footprints,
/turf/open/floor/hexstone,
/area/rogue/under/tomb)
"Us" = (
/obj/structure/door/viewport{
	dir = 4
	},
/obj/effect/mapping_helpers/door/locker,
/turf/open/floor/hexstone,
/area/rogue/under/tomb)
"Xm" = (
/mob/living/carbon/human/species/skeleton/npc/ambush,
/turf/open/floor/dirt,
/area/rogue/under/tomb)
"XK" = (
/mob/living/carbon/human/species/skeleton/npc/warrior/skilled,
/turf/open/floor/hexstone,
/area/rogue/under/tomb)
"Yx" = (
/mob/living/simple_animal/hostile/demon{
	name = "Bonetaker";
	base_constitution = 15;
	base_endurance = 15;
	base_intelligence = 15;
	base_fortune = 15;
	base_perception = 15;
	base_speed = 18;
	base_strength = 20
	},
/obj/effect/decal/cleanable/blood/gibs/up,
/turf/open/floor/hexstone,
/area/rogue/under/tomb)

(1,1,1) = {"
al
al
al
aN
al
al
al
"}
(2,1,1) = {"
aR
aR
aR
ai
aR
aR
aR
"}
(3,1,1) = {"
aR
aZ
aZ
aZ
aZ
aZ
aR
"}
(4,1,1) = {"
aR
aZ
aR
aR
aR
aZ
aR
"}
(5,1,1) = {"
aR
ag
aZ
aZ
aZ
aZ
aR
"}
(6,1,1) = {"
aR
aZ
aR
ab
aR
aR
aR
"}
(7,1,1) = {"
aR
aZ
aZ
aZ
aZ
aZ
aR
"}
(8,1,1) = {"
aR
aZ
aR
aR
aR
aZ
aR
"}
(9,1,1) = {"
aR
aZ
aZ
aZ
aZ
aZ
aR
"}
(10,1,1) = {"
aR
aR
aR
ab
aR
aR
aR
"}
(11,1,1) = {"
aZ
aR
aZ
aZ
aZ
aR
aZ
"}
(12,1,1) = {"
aZ
af
aZ
aR
ag
af
aZ
"}
(13,1,1) = {"
aZ
aR
aZ
aR
aZ
aR
aZ
"}
(14,1,1) = {"
aZ
aR
aZ
aZ
aZ
aR
aZ
"}
(15,1,1) = {"
aR
aR
aR
aZ
aR
aR
aR
"}
(16,1,1) = {"
aR
aj
aR
aZ
aR
aj
aR
"}
(17,1,1) = {"
aR
aZ
aZ
aZ
aZ
aZ
aR
"}
(18,1,1) = {"
aR
Xm
aZ
aZ
aZ
aD
aR
"}
(19,1,1) = {"
aR
gq
aZ
aZ
aZ
ah
aR
"}
(20,1,1) = {"
aR
gq
aZ
aZ
aZ
aD
aR
"}
(21,1,1) = {"
aR
bN
aZ
aZ
aZ
ak
aR
"}
(22,1,1) = {"
aR
aZ
aZ
aZ
aZ
aZ
aR
"}
(23,1,1) = {"
aR
aZ
CK
zh
aL
aO
aR
"}
(24,1,1) = {"
aR
aR
aR
aR
aR
aR
aR
"}

(1,1,2) = {"
al
al
al
aZ
al
al
al
"}
(2,1,2) = {"
aR
aR
aR
af
aR
aR
aR
"}
(3,1,2) = {"
aR
Ny
Qw
nk
Pj
ty
aR
"}
(4,1,2) = {"
aR
Ny
aR
aR
aR
je
aR
"}
(5,1,2) = {"
aR
rX
Qw
wd
Yx
aZ
aR
"}
(6,1,2) = {"
aR
aZ
aR
Pj
aR
aR
aR
"}
(7,1,2) = {"
aR
aZ
aZ
ca
aZ
Jl
aR
"}
(8,1,2) = {"
aR
ab
aR
aR
aR
aZ
aR
"}
(9,1,2) = {"
aR
aZ
aZ
aZ
jO
aZ
aR
"}
(10,1,2) = {"
aR
aR
aZ
aZ
aZ
aZ
aR
"}
(11,1,2) = {"
ab
aZ
aZ
aZ
aZ
aZ
ab
"}
(12,1,2) = {"
af
aZ
aR
aR
aR
aZ
af
"}
(13,1,2) = {"
af
aZ
aR
LL
aR
aZ
ab
"}
(14,1,2) = {"
ab
aZ
aZ
aZ
aZ
aZ
ab
"}
(15,1,2) = {"
aR
aR
aR
aR
aR
Us
aR
"}
(16,1,2) = {"
aR
aZ
aZ
jK
aZ
aZ
aR
"}
(17,1,2) = {"
aR
aZ
PU
jK
aZ
LL
aR
"}
(18,1,2) = {"
aR
XK
aZ
jK
aZ
aZ
aR
"}
(19,1,2) = {"
aR
yr
aZ
jK
aj
aZ
aR
"}
(20,1,2) = {"
aR
vT
aZ
jK
aZ
aZ
aR
"}
(21,1,2) = {"
aR
PU
aZ
jK
aZ
XK
aR
"}
(22,1,2) = {"
aR
aZ
aZ
jK
aZ
aZ
aR
"}
(23,1,2) = {"
aR
aZ
XK
jK
aZ
aO
aR
"}
(24,1,2) = {"
aR
aR
aR
aR
aR
aR
aR
"}
