//MAP CONVERTED BY dmm2tgm.py THIS HEADER COMMENT PREVENTS RECONVERSION, DO NOT REMOVE
"af" = (
/obj/effect/decal/cleanable/dirt/dust,
/turf/open/floor/blocks,
/area/rogue/under/tomb/indoors/rest)
"ar" = (
/turf/open/floor/dirt/road,
/area/rogue/under/tomb)
"cC" = (
/turf/open/floor/dirt,
/area/rogue/under/tomb)
"cH" = (
/obj/structure/fluff/railing/wood,
/turf/open/floor/wood,
/area/rogue/under/tomb/indoors/rest)
"cZ" = (
/obj/machinery/light/fueled/torchholder/l,
/obj/effect/decal/cleanable/dirt/dust,
/turf/open/floor/cobble,
/area/rogue/under/tomb/indoors/rest)
"et" = (
/obj/structure/table/wood/treestump/shroomstump,
/turf/open/floor/dirt,
/area/rogue/under/tomb)
"ew" = (
/turf/closed/wall/mineral/stone,
/area/rogue/under/tomb/indoors/rest)
"eQ" = (
/obj/effect/decal/shadow_floor{
	dir = 1
	},
/obj/effect/decal/cleanable/dirt/dust,
/turf/open/floor/cobble,
/area/rogue/under/tomb/indoors/rest)
"gg" = (
/turf/open/floor/herringbone,
/area/rogue/under/tomb/indoors)
"hy" = (
/obj/machinery/light/fueled/wallfire/candle/r,
/obj/structure/bed/inn,
/obj/item/bedsheet/wool,
/turf/open/floor/carpet/royalblack,
/area/rogue/under/tomb/indoors/rest)
"iF" = (
/obj/item/clothing/gloves/leather{
	pixel_x = -7;
	pixel_y = -9
	},
/obj/effect/decal/cleanable/vomit/old,
/turf/open/floor/carpet/royalblack,
/area/rogue/under/tomb/indoors/rest)
"iR" = (
/turf/closed/mineral/bedrock,
/area/rogue/under/tomb)
"jt" = (
/turf/open/floor/cobblerock,
/area/rogue/under/tomb)
"jB" = (
/obj/structure/door/red,
/turf/open/floor/blocks,
/area/rogue/under/tomb/indoors/rest)
"jT" = (
/turf/closed/wall/mineral/stone,
/area/rogue/under/tomb)
"kP" = (
/obj/structure/stairs/stone,
/turf/open/floor/cobble,
/area/rogue/under/tomb/indoors/rest)
"kS" = (
/turf/open/floor/cobble,
/area/rogue/under/tomb/indoors/rest)
"lG" = (
/obj/structure/stairs/stone{
	dir = 1;
	icon_state = "stonestairs"
	},
/obj/structure/fluff/railing/wood{
	dir = 4;
	pixel_y = 8
	},
/turf/open/floor/cobble,
/area/rogue/under/tomb/indoors/rest)
"lM" = (
/obj/effect/dungeon_directional_helper/east,
/turf/open/floor/naturalstone,
/area/rogue/under/tomb)
"mO" = (
/obj/structure/table/wood/reinforced_alter,
/obj/structure/bars/bent,
/obj/effect/decal/shadow_floor,
/turf/open/floor/blocks,
/area/rogue/under/tomb/indoors/rest)
"mT" = (
/obj/item/clothing/pants/skirt/random{
	pixel_x = 8;
	pixel_y = 9
	},
/obj/effect/decal/cleanable/vomit/old,
/turf/open/floor/carpet/royalblack,
/area/rogue/under/tomb/indoors/rest)
"na" = (
/turf/closed/wall/mineral/craftstone,
/area/rogue/under/tomb/indoors/rest)
"nk" = (
/obj/machinery/light/fueled/torchholder/l,
/obj/effect/decal/cleanable/dirt/dust,
/turf/open/floor/blocks,
/area/rogue/under/tomb/indoors/rest)
"nl" = (
/obj/structure/door/red,
/turf/open/floor/wood/nosmooth,
/area/rogue/under/tomb/indoors/rest)
"no" = (
/obj/structure/table/wood/nice/decorated,
/obj/item/reagent_containers/glass/carafe/silver/redwine{
	pixel_y = 11;
	pixel_x = -2
	},
/turf/open/floor/wood,
/area/rogue/under/tomb/indoors/rest)
"nI" = (
/turf/open/transparent/openspace,
/area/rogue/under/tomb)
"nJ" = (
/obj/effect/decal/cleanable/dirt/dust,
/turf/open/floor/wood,
/area/rogue/under/tomb/indoors/rest)
"ob" = (
/obj/structure/table/stone_small,
/obj/item/reagent_containers/food/snacks/meat/fatty{
	pixel_x = -5;
	pixel_y = 3
	},
/obj/item/reagent_containers/food/snacks/fat{
	pixel_y = 13
	},
/obj/item/reagent_containers/food/snacks/truffles{
	pixel_x = -5;
	pixel_y = 5
	},
/turf/open/floor/cobble,
/area/rogue/under/tomb/indoors/rest)
"oe" = (
/obj/machinery/light/fueled/wallfire/candle/weak/l,
/obj/structure/mannequin/male/female,
/turf/open/floor/herringbone,
/area/rogue/under/tomb/indoors)
"oh" = (
/obj/structure/mannequin,
/turf/open/floor/herringbone,
/area/rogue/under/tomb/indoors)
"om" = (
/turf/closed/wall/mineral/decostone/center,
/area/rogue/under/tomb/indoors)
"ov" = (
/obj/structure/fluff/railing/wood{
	dir = 4
	},
/obj/effect/decal/cleanable/dirt/dust,
/turf/open/floor/wood,
/area/rogue/under/tomb/indoors/rest)
"pe" = (
/obj/structure/table/wood/treestump/shroomstump,
/turf/open/floor/dirt/road,
/area/rogue/under/tomb)
"qv" = (
/turf/open/floor/wood,
/area/rogue/under/tomb/indoors/rest)
"ra" = (
/obj/effect/decal/cobbleedge{
	dir = 9
	},
/turf/open/floor/naturalstone,
/area/rogue/under/tomb)
"sl" = (
/obj/effect/decal/cobbleedge,
/turf/open/floor/naturalstone,
/area/rogue/under/tomb)
"sP" = (
/turf/open/floor/blocks/green,
/area/rogue/under/tomb/indoors/rest)
"tD" = (
/obj/machinery/light/fueled/wallfire/candle/weak/l,
/turf/open/floor/herringbone,
/area/rogue/under/tomb/indoors)
"ue" = (
/obj/structure/door/weak/bolt{
	dir = 1
	},
/turf/open/floor/blocks,
/area/rogue/under/tomb/indoors/rest)
"uy" = (
/obj/machinery/light/fueled/cauldron,
/obj/effect/decal/cleanable/dirt/dust,
/turf/open/floor/blocks/green,
/area/rogue/under/tomb/indoors/rest)
"uA" = (
/turf/open/transparent/openspace,
/area/rogue/under/tomb/indoors/rest)
"wD" = (
/obj/effect/decal/cobbleedge{
	dir = 8
	},
/turf/open/floor/naturalstone,
/area/rogue/under/tomb)
"wE" = (
/obj/structure/fermentation_keg/random/water,
/turf/open/floor/blocks,
/area/rogue/under/tomb/indoors/rest)
"yE" = (
/obj/structure/roguerock,
/turf/open/floor/naturalstone,
/area/rogue/under/tomb)
"yF" = (
/obj/structure/stairs/stone,
/obj/machinery/light/fueled/wallfire/candle/r,
/turf/open/floor/cobble,
/area/rogue/under/tomb/indoors/rest)
"yS" = (
/obj/effect/dungeon_directional_helper/north,
/turf/open/floor/dirt/road,
/area/rogue/under/tomb)
"zC" = (
/obj/effect/decal/cleanable/dirt/dust,
/obj/machinery/light/fueled/wallfire/candle/r,
/turf/open/floor/wood,
/area/rogue/under/tomb/indoors/rest)
"zE" = (
/obj/structure/door/stone,
/turf/open/floor/herringbone,
/area/rogue/under/tomb/indoors)
"Bd" = (
/obj/machinery/light/fueled/torchholder/l,
/obj/effect/decal/cleanable/dirt/dust,
/obj/effect/decal/cleanable/dirt/dust,
/turf/open/floor/blocks,
/area/rogue/under/tomb/indoors/rest)
"Bg" = (
/obj/machinery/light/fueled/hearth/big_fireplace{
	pixel_x = -32
	},
/turf/closed/wall/mineral/stone,
/area/rogue/under/tomb/indoors/rest)
"BU" = (
/obj/effect/decal/cobbleedge{
	dir = 10
	},
/turf/open/floor/naturalstone,
/area/rogue/under/tomb)
"BV" = (
/obj/effect/decal/shadow_floor,
/obj/effect/decal/cleanable/dirt/dust,
/turf/open/floor/blocks,
/area/rogue/under/tomb/indoors/rest)
"FN" = (
/turf/closed/wall/mineral/decostone,
/area/rogue/under/tomb/indoors)
"Gt" = (
/obj/structure/trap/wall_projectile{
	dir = 4
	},
/turf/open/floor/naturalstone,
/area/rogue/under/tomb)
"Hb" = (
/obj/structure/rack,
/obj/item/cooking/pan,
/turf/open/floor/wood,
/area/rogue/under/tomb/indoors/rest)
"Hy" = (
/obj/structure/door/weak/bolt{
	dir = 1
	},
/obj/effect/mapping_helpers/door/locker,
/obj/effect/decal/shadow_floor,
/turf/open/floor/blocks,
/area/rogue/under/tomb/indoors/rest)
"HD" = (
/obj/machinery/light/fueled/lanternpost{
	dir = 1
	},
/turf/open/floor/cobble,
/area/rogue/under/tomb)
"Iq" = (
/obj/structure/trap/bomb,
/turf/open/floor/carpet/red,
/area/rogue/under/tomb/indoors)
"Iu" = (
/obj/effect/decal/shadow_floor{
	dir = 5
	},
/obj/effect/decal/cleanable/dirt/dust,
/turf/open/floor/cobble,
/area/rogue/under/tomb/indoors/rest)
"Jf" = (
/obj/structure/table/stone_small,
/obj/item/reagent_containers/glass/mortar{
	pixel_y = 9
	},
/turf/open/floor/cobble,
/area/rogue/under/tomb/indoors/rest)
"Jl" = (
/obj/effect/decal/cobbleedge{
	dir = 1
	},
/turf/open/floor/naturalstone,
/area/rogue/under/tomb)
"JM" = (
/obj/machinery/light/fueled/torchholder/r,
/turf/open/floor/cobble,
/area/rogue/under/tomb/indoors/rest)
"Li" = (
/obj/structure/roguerock,
/turf/open/floor/cobblerock,
/area/rogue/under/tomb)
"Ly" = (
/obj/effect/decal/cleanable/dirt/dust,
/turf/open/floor/cobble,
/area/rogue/under/tomb/indoors/rest)
"LP" = (
/obj/effect/decal/shadow_floor{
	dir = 4
	},
/obj/structure/fluff/railing/wood{
	dir = 4;
	pixel_y = 8
	},
/turf/open/floor/cobble,
/area/rogue/under/tomb/indoors/rest)
"NH" = (
/obj/structure/closet/crate/chest/neu,
/obj/effect/spawner/map_spawner/loot/potion_ingredient/herb,
/obj/effect/spawner/map_spawner/loot/potion_ingredient/herb,
/obj/effect/spawner/map_spawner/loot/potion_ingredient/herb,
/obj/effect/spawner/map_spawner/loot/potion_ingredient/herb,
/obj/effect/spawner/map_spawner/loot/potion_ingredient/herb,
/obj/effect/decal/cleanable/dirt/dust,
/turf/open/floor/blocks,
/area/rogue/under/tomb/indoors/rest)
"NN" = (
/obj/effect/decal/remains/human,
/obj/item/reagent_containers/glass/bottle{
	pixel_x = -6;
	pixel_y = -6;
	closed = 0
	},
/turf/open/floor/carpet/royalblack,
/area/rogue/under/tomb/indoors/rest)
"Of" = (
/obj/item/candle/yellow,
/obj/structure/table/wood/plain/alt,
/turf/open/floor/wood,
/area/rogue/under/tomb/indoors/rest)
"Pf" = (
/turf/open/floor/blocks,
/area/rogue/under/tomb/indoors/rest)
"Pn" = (
/obj/structure/table/stone_small,
/obj/item/pestle,
/obj/effect/decal/cleanable/dirt/dust,
/turf/open/floor/cobble,
/area/rogue/under/tomb/indoors/rest)
"Qs" = (
/turf/open/floor/carpet/red,
/area/rogue/under/tomb/indoors)
"Qv" = (
/obj/structure/rack/shelf/big{
	pixel_y = 0
	},
/obj/item/reagent_containers/glass/bucket/wooden{
	pixel_x = 5
	},
/obj/item/natural/cloth{
	pixel_x = -4;
	pixel_y = 5
	},
/obj/effect/decal/cleanable/dirt/dust,
/turf/open/floor/blocks,
/area/rogue/under/tomb/indoors/rest)
"Sr" = (
/turf/closed/wall/mineral/decostone/cand,
/area/rogue/under/tomb/indoors)
"SI" = (
/turf/open/floor/naturalstone,
/area/rogue/under/tomb)
"SR" = (
/turf/open/water/swamp,
/area/rogue/under/tomb)
"Tu" = (
/obj/effect/decal/cleanable/dirt/dust,
/turf/open/floor/carpet/purple,
/area/rogue/under/tomb/indoors/rest)
"Tw" = (
/obj/effect/dungeon_directional_helper/west,
/turf/open/floor/naturalstone,
/area/rogue/under/tomb)
"TI" = (
/obj/effect/decal/cleanable/dirt/dust,
/turf/open/floor/blocks/green,
/area/rogue/under/tomb/indoors/rest)
"TT" = (
/obj/structure/flora/grass/herb/random,
/turf/open/floor/dirt,
/area/rogue/under/tomb)
"Un" = (
/turf/open/floor/carpet/purple,
/area/rogue/under/tomb/indoors/rest)
"UE" = (
/obj/effect/decal/cobbleedge{
	dir = 6
	},
/turf/open/floor/naturalstone,
/area/rogue/under/tomb)
"UO" = (
/obj/structure/closet/crate/crafted_closet/dark,
/obj/item/clothing/ring/silver,
/turf/open/floor/carpet/royalblack,
/area/rogue/under/tomb/indoors/rest)
"VX" = (
/obj/structure/mannequin/male,
/turf/open/floor/herringbone,
/area/rogue/under/tomb/indoors)
"Wh" = (
/obj/structure/fluff/railing/wood{
	dir = 4
	},
/turf/open/floor/wood,
/area/rogue/under/tomb/indoors/rest)
"XA" = (
/obj/structure/fluff/walldeco/painting/skull{
	pixel_x = -32
	},
/obj/effect/decal/cleanable/dirt/dust,
/turf/open/floor/wood,
/area/rogue/under/tomb/indoors/rest)
"XX" = (
/mob/living/simple_animal/hostile/retaliate/trufflepig,
/obj/item/clothing/shirt/undershirt/fancy{
	pixel_x = 10;
	pixel_y = 6
	},
/turf/open/floor/carpet/royalblack,
/area/rogue/under/tomb/indoors/rest)
"Yy" = (
/obj/structure/closet/crate/chest/neu,
/obj/item/alch/firedust,
/obj/item/alch/magicdust,
/obj/item/alch/earthdust,
/obj/item/alch/coaldust,
/obj/item/alch/coaldust,
/obj/effect/decal/cleanable/dirt/dust,
/turf/open/floor/blocks,
/area/rogue/under/tomb/indoors/rest)
"ZA" = (
/obj/item/clothing/neck/psycross/g{
	pixel_x = -6;
	pixel_y = 0
	},
/obj/structure/table/stone_small,
/obj/item/weapon/knife/dagger/silver{
	pixel_x = 6;
	pixel_y = 5
	},
/turf/open/floor/carpet/red,
/area/rogue/under/tomb/indoors)

(1,1,1) = {"
iR
iR
iR
iR
iR
iR
iR
iR
cC
ar
ar
ar
SI
Tw
SI
SI
SI
iR
iR
iR
"}
(2,1,1) = {"
iR
iR
iR
iR
iR
iR
iR
TT
cC
ar
ar
SI
SI
SI
SI
SI
iR
iR
iR
iR
"}
(3,1,1) = {"
iR
iR
iR
iR
iR
iR
iR
iR
iR
cC
ar
SI
yE
SI
SI
SI
iR
iR
iR
iR
"}
(4,1,1) = {"
iR
iR
iR
iR
iR
iR
iR
iR
iR
cC
SI
SI
SI
SI
SI
SI
iR
iR
iR
iR
"}
(5,1,1) = {"
iR
iR
iR
iR
iR
iR
iR
iR
SI
SI
SI
SI
iR
SI
SI
iR
iR
iR
iR
iR
"}
(6,1,1) = {"
iR
iR
iR
iR
iR
iR
iR
ar
SI
SI
yE
SI
iR
SI
SI
iR
iR
iR
iR
iR
"}
(7,1,1) = {"
iR
iR
TT
iR
iR
iR
cC
ar
ar
SI
SI
SI
SI
SI
cC
iR
jt
jt
Li
iR
"}
(8,1,1) = {"
iR
iR
cC
iR
ar
ar
ar
ar
iR
SI
SI
SI
SI
SI
cC
iR
iR
jt
jt
iR
"}
(9,1,1) = {"
ar
ar
ar
ar
ar
ar
SI
ar
SI
SI
SI
SI
SI
cC
ar
iR
iR
jt
iR
iR
"}
(10,1,1) = {"
yS
ar
ar
ar
ar
ar
SI
SI
SI
SI
SI
SI
SI
ar
ar
iR
jt
jt
iR
iR
"}
(11,1,1) = {"
ar
SI
SI
SI
SI
SI
SI
ra
wD
BU
SI
SI
SI
ar
ar
cC
ar
iR
iR
iR
"}
(12,1,1) = {"
ew
ew
ew
ew
ew
SI
SI
Jl
HD
sl
SI
SI
ar
ar
iR
cC
iR
iR
iR
iR
"}
(13,1,1) = {"
ew
Jf
Pn
cZ
ew
ew
ew
ew
ew
UE
SI
SI
ar
iR
iR
cC
cC
iR
iR
iR
"}
(14,1,1) = {"
ew
TI
TI
kS
mO
Pf
nk
Pf
ew
SI
SI
SI
ar
iR
SR
cC
TT
iR
iR
iR
"}
(15,1,1) = {"
ew
uy
sP
kS
Hy
af
Pf
Pf
ue
SI
SI
SI
ar
iR
iR
iR
iR
iR
iR
iR
"}
(16,1,1) = {"
ew
sP
sP
Ly
ew
ew
ew
ew
ew
SI
SI
SI
SI
ar
iR
iR
iR
iR
iR
iR
"}
(17,1,1) = {"
ew
ob
Ly
Ly
BV
ew
Bd
Yy
ew
SI
SI
SI
SI
SI
iR
iR
iR
iR
iR
iR
"}
(18,1,1) = {"
ew
kS
Ly
JM
BV
jB
af
NH
ew
SI
SI
SI
SI
SI
cC
iR
iR
iR
iR
iR
"}
(19,1,1) = {"
ew
kS
kP
ew
wE
ew
af
Qv
ew
SI
SI
SI
SI
SI
iR
iR
iR
iR
iR
iR
"}
(20,1,1) = {"
ew
ew
ew
ew
ew
ew
ew
ew
ew
SI
SI
lM
SI
SI
iR
iR
iR
iR
iR
iR
"}

(1,1,2) = {"
iR
iR
iR
iR
iR
iR
iR
iR
iR
jt
jt
SI
SI
nI
nI
nI
nI
iR
iR
iR
"}
(2,1,2) = {"
iR
iR
iR
iR
TT
iR
iR
iR
iR
iR
jt
SI
SI
nI
nI
nI
iR
iR
iR
iR
"}
(3,1,2) = {"
iR
iR
iR
iR
et
cC
Li
iR
iR
iR
Li
SI
SI
SI
nI
nI
iR
iR
iR
iR
"}
(4,1,2) = {"
iR
iR
iR
iR
cC
pe
jt
iR
iR
iR
iR
SI
jt
SI
yE
nI
iR
iR
iR
iR
"}
(5,1,2) = {"
iR
iR
iR
iR
ar
ar
ar
iR
iR
iR
iR
jt
Li
jt
SI
iR
iR
iR
iR
iR
"}
(6,1,2) = {"
iR
iR
iR
iR
ar
SI
ar
ar
iR
iR
iR
jt
jt
SI
SI
iR
iR
iR
iR
iR
"}
(7,1,2) = {"
iR
iR
iR
iR
SI
iR
iR
ar
SI
nI
iR
SI
Li
SI
SI
SI
nI
nI
nI
iR
"}
(8,1,2) = {"
iR
SI
SI
iR
nI
iR
iR
SI
SI
nI
nI
SI
SI
iR
iR
iR
iR
nI
nI
iR
"}
(9,1,2) = {"
SI
SI
SI
nI
nI
nI
iR
SI
nI
nI
nI
nI
SI
iR
iR
iR
iR
iR
iR
iR
"}
(10,1,2) = {"
SI
SI
SI
SI
nI
nI
SI
SI
nI
nI
nI
nI
nI
nI
iR
iR
FN
om
FN
iR
"}
(11,1,2) = {"
SI
SI
SI
nI
nI
nI
nI
nI
nI
nI
nI
nI
iR
iR
iR
FN
Sr
ZA
Sr
FN
"}
(12,1,2) = {"
ew
ew
ew
ew
ew
nI
nI
nI
nI
nI
nI
nI
iR
iR
iR
FN
oe
Qs
tD
FN
"}
(13,1,2) = {"
ew
ew
nJ
Of
ew
ew
ew
ew
ew
nI
nI
nI
iR
iR
iR
FN
gg
Iq
oh
FN
"}
(14,1,2) = {"
ew
Bg
nJ
nJ
nJ
nJ
XA
no
ew
nI
nI
nI
nI
iR
iR
FN
VX
Qs
gg
FN
"}
(15,1,2) = {"
ew
Hb
nJ
Un
nJ
zC
qv
nJ
ew
nI
nI
nI
nI
iR
iR
FN
FN
zE
FN
FN
"}
(16,1,2) = {"
ew
nJ
qv
Tu
nJ
na
na
nl
ew
nI
nI
nI
nI
nI
iR
iR
SI
Gt
SI
iR
"}
(17,1,2) = {"
ew
qv
ov
Wh
Wh
na
UO
mT
ew
nI
nI
nI
nI
nI
iR
iR
iR
SI
iR
iR
"}
(18,1,2) = {"
ew
qv
lG
LP
Iu
na
XX
NN
ew
nI
nI
nI
nI
nI
nI
SI
SI
SI
iR
iR
"}
(19,1,2) = {"
ew
cH
uA
yF
eQ
na
iF
hy
ew
nI
nI
nI
nI
nI
iR
iR
iR
SI
iR
iR
"}
(20,1,2) = {"
ew
ew
ew
ew
ew
ew
ew
ew
ew
nI
nI
nI
nI
nI
iR
iR
iR
jT
iR
iR
"}
