//MAP CONVERTED BY dmm2tgm.py THIS HEADER COMMENT PREVENTS RECONVERSION, DO NOT REMOVE
"bE" = (
/mob/living/carbon/human/species/orc/tribal,
/turf/open/floor/dirt/road,
/area/rogue/under/tomb)
"cy" = (
/obj/item/organ/heart,
/obj/effect/decal/cleanable/blood,
/turf/open/floor/dirt/road,
/area/rogue/under/tomb)
"eC" = (
/obj/effect/decal/cleanable/blood,
/turf/open/floor/dirt/road,
/area/rogue/under/tomb)
"eZ" = (
/obj/effect/decal/cleanable/blood,
/turf/open/floor/cobblerock,
/area/rogue/under/tomb)
"fh" = (
/obj/effect/decal/cleanable/dirt/dust,
/turf/open/floor/cobble,
/area/rogue/under/tomb)
"gA" = (
/obj/effect/dungeon_directional_helper/east,
/turf/open/floor/dirt/road,
/area/rogue/under/tomb)
"kF" = (
/turf/open/floor/cobble,
/area/rogue/under/tomb)
"kS" = (
/turf/open/floor/cobblerock,
/area/rogue/under/tomb)
"mg" = (
/obj/item/clothing/face/facemask/goldmask,
/turf/open/floor/ruinedwood,
/area/rogue/under/tomb)
"mh" = (
/obj/effect/dungeon_directional_helper/west,
/turf/open/floor/dirt/road,
/area/rogue/under/tomb)
"pm" = (
/obj/item/weapon/knife/dagger/silver,
/obj/item/natural/stone,
/obj/item/natural/stone{
	pixel_y = -6;
	pixel_x = 4
	},
/obj/item/natural/stone{
	pixel_y = -12;
	pixel_x = -7
	},
/obj/item/natural/stone{
	pixel_y = 4;
	pixel_x = -7
	},
/obj/item/natural/stone{
	pixel_y = 7;
	pixel_x = 11
	},
/obj/effect/decal/cleanable/blood,
/turf/open/floor/cobblerock,
/area/rogue/under/tomb)
"rf" = (
/obj/item/restraints/legcuffs/beartrap/armed,
/obj/item/reagent_containers/food/snacks/pie/cooked/apple,
/turf/open/floor/ruinedwood,
/area/rogue/under/tomb)
"sp" = (
/obj/effect/decal/cleanable/blood/footprints{
	dir = 4
	},
/turf/open/floor/cobblerock,
/area/rogue/under/tomb)
"sO" = (
/obj/item/clothing/neck/psycross/silver,
/turf/open/floor/ruinedwood,
/area/rogue/under/tomb)
"ti" = (
/obj/structure/table/wood/plain,
/obj/item/natural/cloth,
/obj/item/natural/cloth{
	pixel_y = 5;
	pixel_x = -7
	},
/turf/open/floor/cobble,
/area/rogue/under/tomb)
"uK" = (
/obj/structure/table/wood/plain,
/obj/item/needle,
/turf/open/floor/cobble,
/area/rogue/under/tomb)
"uO" = (
/obj/structure/bed/shit,
/mob/living/carbon/human/species/skeleton/npc/peasant,
/turf/open/floor/cobblerock,
/area/rogue/under/tomb)
"vf" = (
/turf/open/floor/dirt/road,
/area/rogue/under/tomb)
"vK" = (
/turf/open/floor/blocks,
/area/rogue/under/tomb)
"xa" = (
/obj/item/restraints/legcuffs/beartrap/armed,
/obj/item/ingot/gold,
/turf/open/floor/cobblerock,
/area/rogue/under/tomb)
"xd" = (
/obj/item/organ/eyes,
/turf/open/floor/dirt/road,
/area/rogue/under/tomb)
"xs" = (
/obj/effect/dungeon_directional_helper/south,
/turf/open/floor/cobblerock,
/area/rogue/under/tomb)
"yf" = (
/turf/closed/wall/mineral/tent,
/area/rogue/under/tomb)
"yl" = (
/mob/living/carbon/human/species/skeleton/npc/warrior/skilled,
/obj/structure/bed/mediocre,
/obj/item/organ/eyes,
/obj/effect/decal/cleanable/blood,
/obj/effect/decal/cleanable/blood/gibs/old,
/turf/open/floor/herringbone,
/area/rogue/under/tomb)
"yy" = (
/obj/effect/decal/cleanable/blood,
/turf/open/floor/herringbone,
/area/rogue/under/tomb)
"yP" = (
/obj/item/ingot/gold,
/turf/open/floor/ruinedwood,
/area/rogue/under/tomb)
"yY" = (
/obj/item/organ/lungs,
/turf/open/floor/dirt/road,
/area/rogue/under/tomb)
"zs" = (
/obj/item/reagent_containers/food/snacks/rotten/meat,
/obj/item/organ/heart,
/obj/effect/decal/cleanable/blood,
/turf/open/floor/ruinedwood,
/area/rogue/under/tomb)
"AZ" = (
/obj/structure/fermentation_keg/random/water,
/obj/item/reagent_containers/glass/bowl,
/turf/open/floor/cobble,
/area/rogue/under/tomb)
"Bv" = (
/obj/effect/decal/cleanable/blood,
/mob/living/carbon/human/species/orc/tribal,
/turf/open/floor/dirt/road,
/area/rogue/under/tomb)
"BP" = (
/turf/open/floor/herringbone,
/area/rogue/under/tomb)
"Dq" = (
/obj/machinery/light/fueled/hearth,
/turf/open/floor/blocks,
/area/rogue/under/tomb)
"Fz" = (
/obj/item/reagent_containers/food/snacks/rotten/meat,
/obj/effect/decal/cleanable/blood,
/turf/open/floor/ruinedwood,
/area/rogue/under/tomb)
"Hu" = (
/obj/item/paper/scroll,
/obj/structure/table/wood/plain,
/obj/item/natural/feather,
/turf/open/floor/cobblerock,
/area/rogue/under/tomb)
"IJ" = (
/obj/structure/bed/shit,
/mob/living/carbon/human/species/skeleton/npc/peasant,
/obj/effect/decal/cleanable/dirt/dust,
/obj/effect/decal/cleanable/blood,
/obj/effect/decal/cleanable/blood/gibs/old,
/turf/open/floor/blocks,
/area/rogue/under/tomb)
"IO" = (
/obj/item/reagent_containers/glass/bucket/pot,
/obj/structure/table/wood/plain,
/turf/open/floor/blocks,
/area/rogue/under/tomb)
"IS" = (
/mob/living/carbon/human/species/skeleton/npc/peasant,
/obj/structure/bed/mediocre,
/obj/item/reagent_containers/food/snacks/hardtack,
/obj/effect/decal/cleanable/blood/gibs/old,
/turf/open/floor/cobble,
/area/rogue/under/tomb)
"Kn" = (
/obj/item/organ/brain,
/obj/effect/decal/cleanable/blood,
/turf/open/floor/ruinedwood,
/area/rogue/under/tomb)
"Lk" = (
/obj/item/organ/brain,
/turf/open/floor/ruinedwood,
/area/rogue/under/tomb)
"Ml" = (
/obj/item/organ/tongue,
/turf/open/floor/herringbone,
/area/rogue/under/tomb)
"Ms" = (
/obj/effect/decal/cleanable/blood,
/mob/living/carbon/human/species/orc/tribal,
/turf/open/floor/ruinedwood,
/area/rogue/under/tomb)
"MS" = (
/obj/structure/table/wood/plain,
/obj/item/weapon/knife/hunting{
	pixel_y = 3;
	pixel_x = -5
	},
/obj/item/reagent_containers/food/snacks/rotten/mince{
	pixel_x = 6;
	pixel_y = 8
	},
/obj/item/reagent_containers/food/snacks/meat/salami{
	pixel_y = -1;
	pixel_x = -5
	},
/obj/item/reagent_containers/food/snacks/hardtack{
	pixel_y = 7;
	pixel_x = 9
	},
/obj/item/reagent_containers/food/snacks/hardtack{
	pixel_y = 7;
	pixel_x = 9
	},
/turf/open/floor/blocks,
/area/rogue/under/tomb)
"MV" = (
/obj/item/reagent_containers/food/snacks/rotten/meat,
/turf/open/floor/dirt/road,
/area/rogue/under/tomb)
"RU" = (
/turf/closed/wall/mineral/wooddark,
/area/rogue/under/tomb)
"Sy" = (
/obj/structure/closet/crate/chest/old_crate,
/obj/item/weapon/sword/rapier/silver,
/obj/item/clothing/armor/cuirass,
/obj/item/clothing/face/facemask,
/obj/item/organ/heart,
/obj/effect/decal/cleanable/blood,
/obj/item/reagent_containers/food/snacks/hardtack,
/turf/open/floor/herringbone,
/area/rogue/under/tomb)
"Tk" = (
/obj/effect/decal/cleanable/dirt/dust,
/turf/open/floor/blocks,
/area/rogue/under/tomb)
"UY" = (
/turf/open/floor/ruinedwood,
/area/rogue/under/tomb)
"Vb" = (
/obj/item/reagent_containers/glass/bottle,
/turf/open/floor/cobblerock,
/area/rogue/under/tomb)
"Vk" = (
/obj/item/organ/lungs,
/turf/open/floor/ruinedwood,
/area/rogue/under/tomb)
"Wg" = (
/obj/item/reagent_containers/glass/bottle/beer,
/turf/open/floor/cobblerock,
/area/rogue/under/tomb)
"Ww" = (
/obj/effect/dungeon_directional_helper/north,
/turf/open/floor/cobblerock,
/area/rogue/under/tomb)
"Xs" = (
/turf/closed/mineral/bedrock,
/area/rogue/under/tomb)
"XZ" = (
/obj/structure/door,
/turf/open/floor/cobblerock,
/area/rogue/under/tomb)
"Yy" = (
/obj/effect/decal/cleanable/blood,
/turf/open/floor/ruinedwood,
/area/rogue/under/tomb)
"YW" = (
/obj/structure/barricade/wooden,
/obj/structure/barricade/wooden/crude,
/turf/open/floor/cobblerock,
/area/rogue/under/tomb)
"ZO" = (
/obj/effect/decal/cleanable/dirt/dust,
/obj/structure/bed/mediocre,
/turf/open/floor/cobble,
/area/rogue/under/tomb)

(1,1,1) = {"
Xs
Xs
Xs
Xs
Xs
mh
kS
Xs
Xs
Xs
Xs
Xs
"}
(2,1,1) = {"
Xs
uK
fh
kF
XZ
kS
vf
Xs
Wg
Vb
Hu
Xs
"}
(3,1,1) = {"
Xs
ti
kF
AZ
RU
vf
kS
Xs
kS
kS
Wg
Xs
"}
(4,1,1) = {"
Xs
ZO
kF
IS
Xs
kS
vf
Xs
YW
uO
pm
Xs
"}
(5,1,1) = {"
Xs
Xs
XZ
Xs
Xs
vf
kS
RU
XZ
RU
Xs
Xs
"}
(6,1,1) = {"
kS
vf
vf
kS
kS
vf
kS
kS
sp
vf
vf
kS
"}
(7,1,1) = {"
Ww
kS
kS
vf
kS
kS
vf
kS
vf
vf
kS
xs
"}
(8,1,1) = {"
Xs
Xs
Xs
Xs
Xs
kS
vf
RU
Xs
Xs
Xs
Xs
"}
(9,1,1) = {"
Xs
IO
Dq
Tk
RU
kS
kS
XZ
yy
yf
yl
Xs
"}
(10,1,1) = {"
Xs
IJ
vK
vK
XZ
vf
kS
Xs
BP
Ml
yy
Xs
"}
(11,1,1) = {"
Xs
MS
Tk
vK
Xs
vf
kS
Xs
yy
BP
Sy
Xs
"}
(12,1,1) = {"
Xs
Xs
Xs
Xs
Xs
gA
vf
Xs
Xs
Xs
Xs
Xs
"}

(1,1,2) = {"
Xs
Xs
Xs
Xs
kS
kS
kS
kS
Xs
Xs
Xs
Xs
"}
(2,1,2) = {"
Xs
bE
Fz
Xs
Xs
vf
vf
Xs
Xs
xd
Ms
Xs
"}
(3,1,2) = {"
Xs
Kn
UY
vf
Xs
kS
kS
Xs
vf
vf
Fz
Xs
"}
(4,1,2) = {"
Xs
Xs
Lk
vf
kS
kS
vf
kS
Yy
xd
Xs
Xs
"}
(5,1,2) = {"
kS
Xs
Xs
kS
UY
xa
UY
kS
eC
Xs
Xs
vf
"}
(6,1,2) = {"
vf
vf
kS
vf
kS
UY
mg
rf
UY
kS
kS
kS
"}
(7,1,2) = {"
kS
kS
kS
kS
UY
UY
sO
UY
kS
kS
vf
kS
"}
(8,1,2) = {"
kS
Xs
Xs
vf
eZ
yP
kS
UY
vf
Xs
Xs
kS
"}
(9,1,2) = {"
Xs
Xs
Vk
vf
vf
kS
vf
vf
kS
eC
Xs
Xs
"}
(10,1,2) = {"
Xs
MV
Yy
vf
Xs
kS
kS
Xs
zs
UY
cy
Xs
"}
(11,1,2) = {"
Xs
Bv
yY
Xs
Xs
vf
kS
Xs
Xs
vf
bE
Xs
"}
(12,1,2) = {"
Xs
Xs
Xs
Xs
kS
kS
vf
kS
Xs
Xs
Xs
Xs
"}
